Date,HB,HBName,DailyPositive,CumulativePositive,CrudeRatePositive,CrudeRate7DayPositive,DailyDeaths,CumulativeDeaths,CrudeRateDeaths,DailyNegative,CumulativeNegative,CrudeRateNegative,TotalTests,PositiveTests,PositivePercentage,PositivePercentage7Day,TotalPillar1,TotalPillar2,HospitalAdmissions,HospitalAdmissionsQF,ICUAdmissions,ICUAdmissionsQF,PositivePillar1,PositivePillar2,DailyCases,CumulativeCases,Deaths
2020-02-28,S92000003,Scotland,1,1,0.0182949140139041,,0,0,0.0,121,704,12.879619465788512,164,2,1.2195121951219512,,164,0,,:,,:,2,0,1,1,0
2020-02-29,S92000003,Scotland,0,1,0.0182949140139041,,0,0,0.0,63,767,14.032199048664472,90,0,0.0,,90,0,,:,,:,0,0,0,1,0
2020-03-01,S92000003,Scotland,2,3,0.0548847420417124,,0,0,0.0,72,839,15.349432857665567,92,2,2.1739130434782608,,92,0,6.0,,,:,2,0,2,3,0
2020-03-02,S92000003,Scotland,1,4,0.0731796560556165,,0,0,0.0,190,1029,18.825466520307355,264,4,1.5151515151515151,,264,0,11.0,,,:,4,0,1,4,0
2020-03-03,S92000003,Scotland,3,7,0.1280643980973289,,0,0,0.0,209,1238,22.64910354921332,288,6,2.083333333333333,,288,0,13.0,,,:,6,0,3,7,0
2020-03-04,S92000003,Scotland,6,13,0.2378338821807537,,0,0,0.0,177,1415,25.88730332967436,255,10,3.92156862745098,,255,0,10.0,,,:,10,0,6,13,0
2020-03-05,S92000003,Scotland,2,15,0.274423710208562,0.274423710208562,0,0,0.0,179,1594,29.16209293816319,266,8,3.007518796992481,2.255109231853418,266,0,19.0,,,:,8,0,2,15,0
2020-03-06,S92000003,Scotland,6,21,0.3841931942919868,0.3658982802780827,0,0,0.0,196,1790,32.7478960848884,324,12,3.7037037037037033,2.6599113362887903,324,0,21.0,,,:,12,0,6,21,0
2020-03-07,S92000003,Scotland,6,27,0.4939626783754116,0.4756677643615075,0,0,0.0,122,1912,34.979875594584705,218,17,7.79816513761468,3.456356180433509,218,0,10.0,,,:,17,0,6,27,0
2020-03-08,S92000003,Scotland,3,30,0.5488474204171241,0.4939626783754116,0,0,0.0,110,2022,36.99231613611416,192,17,8.854166666666668,4.095185390149418,192,0,11.0,,,:,17,0,3,30,0
2020-03-09,S92000003,Scotland,16,46,0.8415660446395901,0.7683863885839736,0,0,0.0,273,2295,41.98682766190999,453,39,8.609271523178808,5.460921843687375,453,0,18.0,,,:,39,0,16,46,0
2020-03-10,S92000003,Scotland,21,67,1.225759238931577,1.0976948408342482,0,0,0.0,353,2648,48.44493230881815,588,47,7.993197278911565,6.533101045296168,588,0,30.0,,,:,47,0,21,67,0
2020-03-11,S92000003,Scotland,25,92,1.68313208927918,1.4452982070984266,0,0,0.0,418,3066,56.09220636663008,741,58,7.827260458839406,7.117181883537024,741,0,29.0,,1.0,,58,0,25,92,0
2020-03-12,S92000003,Scotland,38,130,2.3783388218075374,2.103915111598975,1,1,0.0182949140139041,515,3581,65.5140870837907,893,80,8.958566629339305,7.9202112056321505,893,0,24.0,,0.0,,80,0,38,130,1
2020-03-13,S92000003,Scotland,48,178,3.256494694474936,2.872301500182949,0,1,0.0182949140139041,528,4109,75.17380168313208,809,80,9.88875154511743,8.680020544427324,809,0,25.0,,0.0,,80,0,48,178,1
2020-03-14,S92000003,Scotland,19,197,3.604098060739114,3.110135382363703,2,3,0.0548847420417124,322,4431,81.06476399560923,525,20,3.8095238095238098,8.117114972625565,525,0,21.0,,1.0,,20,0,19,197,3
2020-03-15,S92000003,Scotland,12,209,3.823637028905964,3.2747896084888404,0,3,0.0548847420417124,272,4703,86.04098060739115,428,28,6.5420560747663545,7.933288257831868,428,0,16.0,,1.0,,28,0,12,209,3
2020-03-16,S92000003,Scotland,21,230,4.20783022319795,3.36626417855836,1,4,0.0731796560556165,490,5193,95.00548847420416,713,35,4.908835904628331,7.4089844581647855,713,0,33.0,,3.0,,35,0,21,230,4
2020-03-17,S92000003,Scotland,43,273,4.994511525795828,3.768752286864252,2,6,0.1097694840834248,549,5742,105.04939626783754,853,62,7.268464243845251,7.315598548972188,853,0,42.0,,1.0,,62,0,43,273,6
2020-03-18,S92000003,Scotland,41,314,5.744603000365898,4.061470911086718,0,6,0.1097694840834248,522,6264,114.5993413830955,895,56,6.256983240223464,7.056293979671619,895,0,43.0,,3.0,,56,0,41,314,6
2020-03-19,S92000003,Scotland,50,364,6.659348701061106,4.281009879253568,3,9,0.1646542261251372,575,6839,125.11891694109038,946,61,6.4482029598308666,6.616366802089379,946,0,42.0,,4.0,,61,0,50,364,9
2020-03-20,S92000003,Scotland,84,448,8.196121478229053,4.939626783754116,5,14,0.2561287961946579,558,7397,135.32747896084888,946,97,10.253699788583509,6.765925367508481,946,0,73.0,,8.0,,97,0,84,448,14
2020-03-21,S92000003,Scotland,67,515,9.42188071716063,5.817782656421515,6,20,0.3658982802780827,440,7837,143.3772411269667,704,81,11.505681818181818,7.657247037374658,704,0,63.0,,6.0,,81,0,67,515,20
2020-03-22,S92000003,Scotland,74,589,10.775704354189536,6.952067325283571,5,25,0.4573728503476034,354,8191,149.85364068788877,682,90,13.19648093841642,8.398675727478654,682,0,52.0,,8.0,,90,0,74,589,25
2020-03-23,S92000003,Scotland,138,727,13.300402488108306,9.092572264910356,4,29,0.5305525064032199,580,8771,160.46469081595316,1074,164,15.27001862197393,10.01639344262295,1074,0,96.0,,12.0,,164,0,138,727,29
2020-03-24,S92000003,Scotland,167,894,16.355653128430298,11.361141602634468,7,36,0.6586169045005489,658,9429,172.5027442371021,1261,206,16.33624107850912,11.601106330669944,1261,0,96.0,,10.0,,206,0,167,894,36
2020-03-25,S92000003,Scotland,188,1082,19.79509696304428,14.050493962678376,11,47,0.8598609586534943,665,10094,184.6688620563484,1374,251,18.26783114992722,13.596679547731505,1374,0,123.0,,13.0,,251,0,188,1082,47
2020-03-26,S92000003,Scotland,223,1305,23.87486278814489,17.21551408708379,12,59,1.079399926820344,758,10852,198.53640687888768,1459,269,18.437285812200138,15.44,1459,0,155.0,,15.0,,269,0,223,1305,59
2020-03-27,S92000003,Scotland,274,1579,28.88766922795463,20.691547749725576,11,70,1.2806439809732897,708,11560,211.4892060007318,1445,322,22.28373702422145,17.289661207650955,1445,0,150.0,,16.0,,322,0,274,1579,70
2020-03-28,S92000003,Scotland,204,1783,32.61983168679107,23.19795096963044,29,99,1.8111964873765087,617,12177,222.77716794731063,1204,259,21.511627906976745,18.366866690198847,1204,0,156.0,,17.0,,259,0,204,1783,99
2020-03-29,S92000003,Scotland,197,1980,36.223929747530185,25.448225393340653,20,119,2.177094767654592,383,12560,229.784120014636,948,262,27.637130801687764,19.7718197375927,948,0,136.0,,28.0,,262,0,197,1980,119
2020-03-30,S92000003,Scotland,317,2297,42.0234174899378,28.72301500182949,30,149,2.725942188071716,836,13396,245.0786681302598,1632,383,23.46813725490196,20.93746648074654,1632,0,193.0,,22.0,,383,0,317,2297,149
2020-03-31,S92000003,Scotland,341,2638,48.2619831686791,31.90633004024881,38,187,3.421148920600073,952,14348,262.4954262714965,1800,399,22.166666666666668,21.750152098965728,1800,0,184.0,,18.0,,399,0,341,2638,187
2020-04-01,S92000003,Scotland,389,3027,55.37870472008781,35.583607757043545,46,233,4.262714965239663,828,15176,277.6436150750092,1717,455,26.499708794408853,23.01812836844684,1717,0,216.0,,24.0,,455,0,389,3027,233
2020-04-02,S92000003,Scotland,351,3378,61.800219538968165,37.92535675082327,36,269,4.921331869740213,750,15926,291.36480058543725,1618,416,25.71075401730532,24.08336549594751,1618,0,171.0,,18.0,,416,0,351,3378,269
2020-04-03,S92000003,Scotland,381,3759,68.77058177826564,39.88291255031101,58,327,5.9824368825466525,822,16748,306.4032199048665,1712,467,27.278037383177573,24.842441915153795,1712,0,212.0,,27.0,,467,0,381,3759,327
2020-04-04,S92000003,Scotland,260,4019,73.52725942188073,40.90742773508965,28,355,6.494694474935968,549,17297,316.4471276984998,1241,327,26.349717969379533,25.39370078740157,1241,0,154.0,,21.0,,327,0,260,4019,355
2020-04-05,S92000003,Scotland,225,4244,77.64361507500915,41.41968532747896,47,402,7.3545554335894625,483,17780,325.28357116721554,1117,294,26.320501342882725,25.29297776137308,1117,0,161.0,,25.0,,294,0,225,4244,402
2020-04-06,S92000003,Scotland,404,4648,85.03476033662642,43.01134284668862,63,465,8.507135016465423,813,18593,340.1573362605196,1798,522,29.03225806451613,26.174679632827413,1798,0,202.0,,15.0,,522,0,404,4648,465
2020-04-07,S92000003,Scotland,352,5000,91.47457006952068,43.212586900841565,49,514,9.403585803146726,783,19376,354.4822539334065,1696,449,26.474056603773583,26.88320029360492,1696,0,171.0,,16.0,,449,0,352,5000,514
2020-04-08,S92000003,Scotland,343,5343,97.7497255762898,42.37102085620197,54,568,10.391511159897547,756,20132,368.313208927918,1657,417,25.16596258298129,26.681428176031,1657,0,158.0,,13.0,,417,0,343,5343,568
2020-04-09,S92000003,Scotland,304,5647,103.31137943651666,41.51115989754848,66,634,11.59897548481522,786,20918,382.69301134284666,1653,389,23.5329703569268,26.347250321868675,1653,0,130.0,,12.0,,389,0,304,5647,634
2020-04-10,S92000003,Scotland,329,5976,109.33040614709113,40.55982436882547,58,692,12.660080497621662,780,21698,396.96304427369193,1691,403,23.832052040212893,25.80853220307749,1691,0,117.0,,8.0,,403,0,329,5976,692
2020-04-11,S92000003,Scotland,185,6161,112.71496523966336,39.18770581778266,50,742,13.574826198316869,536,22234,406.7691181851445,1184,261,22.04391891891892,25.33345683586513,1184,0,80.0,,9.0,,261,0,185,6161,742
2020-04-12,S92000003,Scotland,220,6381,116.73984632272229,39.096231247713135,48,790,14.452982070984266,455,22689,415.0933040614709,1062,294,27.68361581920904,25.46317847500233,1062,0,85.0,,8.0,,294,0,220,6381,790
2020-04-13,S92000003,Scotland,359,6740,123.30772045371388,38.27296011708745,41,831,15.203073545554336,739,23428,428.61324551774607,1575,429,27.23809523809524,25.118843886670472,1575,0,104.0,,8.0,,429,0,359,6740,831
2020-04-14,S92000003,Scotland,346,7086,129.6377607025247,38.16319063300403,51,882,16.136114160263446,729,24157,441.95023783388217,1629,438,26.887661141804784,25.17462443785284,1629,0,101.0,,6.0,,438,0,346,7086,882
2020-04-15,S92000003,Scotland,331,7417,135.69337724112697,37.943651664837176,42,924,16.90450054884742,874,25031,457.9399926820344,1740,399,22.93103448275862,24.80539206379343,1740,0,98.0,,6.0,,399,0,331,7417,924
2020-04-16,S92000003,Scotland,428,7845,143.52360043907794,40.212221002561286,43,967,17.6911818514453,982,26013,475.90559824368825,1969,513,26.0538344337227,25.225806451612904,1968,1,97.0,,9.0,,512,1,428,7845,967
2020-04-17,S92000003,Scotland,394,8239,150.73179656055618,41.40139041346506,38,1005,18.38638858397365,946,26959,493.21258690084153,1855,462,24.90566037735849,25.38587252587616,1855,0,110.0,,5.0,,462,0,394,8239,1005
2020-04-18,S92000003,Scotland,264,8503,155.56165386022687,42.84668862056349,52,1057,19.33772411269667,706,27665,506.1287961946579,1397,323,23.120973514674304,25.456488821590806,1397,0,74.0,,7.0,,323,0,264,8503,1057
2020-04-19,S92000003,Scotland,159,8662,158.4705451884376,41.73069886571533,46,1103,20.17929015733626,553,28218,516.2458836443468,1115,220,19.730941704035875,24.680851063829788,1115,0,58.0,,8.0,,220,0,159,8662,1103
2020-04-20,S92000003,Scotland,348,9010,164.83717526527627,41.52945481156239,61,1164,21.29527991218441,998,29216,534.5042078302232,1983,442,22.28946041351488,23.930527036276523,1983,0,65.0,,5.0,,442,0,348,9010,1164
2020-04-21,S92000003,Scotland,400,9410,172.1551408708379,42.51738016831321,51,1215,22.22832052689353,1030,30246,553.3479692645444,2123,476,22.42110221384833,23.27204071581021,2123,0,70.0,,5.0,,476,0,400,9410,1215
2020-04-22,S92000003,Scotland,340,9750,178.3754116355653,42.68203439443835,46,1261,23.069886571533115,1051,31297,572.5759238931577,2113,419,19.82962612399432,22.73994424532059,2113,0,65.0,,5.0,,419,0,340,9750,1261
2020-04-23,S92000003,Scotland,314,10064,184.1200146359312,40.59641419685328,49,1310,23.96633735821441,1052,32349,591.8221734357849,2034,396,19.469026548672566,21.69572107765452,2032,2,68.0,,7.0,,396,0,314,10064,1310
2020-04-24,S92000003,Scotland,306,10370,189.71825832418588,38.98646176362971,38,1348,24.661544090742776,1064,33413,611.2879619465789,1979,363,18.342597271349167,20.70778405524168,1978,1,91.0,,7.0,,363,0,306,10370,1348
2020-04-25,S92000003,Scotland,184,10554,193.08452250274425,37.52286864251738,48,1396,25.53969996341017,713,34126,624.3322356384925,1409,222,15.755855216465578,19.89651928504233,1406,3,42.0,,1.0,,222,0,184,10554,1396
2020-04-26,S92000003,Scotland,171,10725,196.21295279912184,37.74240761068423,43,1439,26.326381266008053,707,34833,637.2667398463227,1315,212,16.121673003802282,19.52763198518061,1205,110,39.0,,1.0,,204,8,171,10725,1439
2020-04-27,S92000003,Scotland,434,11159,204.15294548115625,39.31577021587999,60,1499,27.4240761068423,1866,36699,671.4050493962678,3362,536,15.942891136228434,18.30484827345657,2327,1035,76.0,,1.0,,435,101,434,11159,1499
2020-04-28,S92000003,Scotland,383,11542,211.1598975484815,39.00475667764361,40,1539,28.155872667398462,1919,38618,706.5129893889499,3394,463,13.64172068355922,16.730744585415867,2405,989,72.0,,1.0,,387,76,383,11542,1539
2020-04-29,S92000003,Scotland,431,11973,219.04500548847423,40.66959385290889,38,1577,28.85107939992682,2864,41482,758.9096231247713,4607,498,10.809637508139788,14.861878453038674,2671,1936,49.0,,7.0,,380,118,431,11973,1577
2020-04-30,S92000003,Scotland,337,12310,225.2103915111599,41.090376875228685,43,1620,29.63776070252469,3071,44553,815.0933040614709,4937,435,8.811018837350618,12.993381897824122,3013,1924,56.0,,4.0,,369,66,337,12310,1620
2020-05-01,S92000003,Scotland,375,12685,232.070984266374,42.35272594218807,48,1668,30.515916575192097,3283,47836,875.1555067691182,5240,460,8.778625954198473,11.646884272997031,2934,2306,56.0,,6.0,,347,113,375,12685,1668
2020-05-02,S92000003,Scotland,222,12907,236.13245517746063,43.04793267471644,44,1712,31.32089279180388,2257,50093,916.4471276984998,3601,278,7.720077756178839,10.893559117024497,1834,1767,47.0,,3.0,,198,80,222,12907,1712
2020-05-03,S92000003,Scotland,188,13095,239.57189901207465,43.3589462129528,37,1749,31.997804610318333,2074,52167,954.390779363337,3541,244,6.890708839310928,10.159682030541802,1721,1820,40.0,,2.0,,156,88,188,13095,1749
2020-05-04,S92000003,Scotland,330,13425,245.609220636663,41.456275155506766,40,1789,32.729601170874496,2533,54700,1000.7317965605564,4592,434,9.451219512195122,9.400909334046537,3087,1505,52.0,,3.0,,370,64,330,13425,1789
2020-05-05,S92000003,Scotland,288,13713,250.8781558726674,39.71825832418588,50,1839,33.6443468715697,2720,57420,1050.4939626783755,4702,382,8.124202467035305,8.747597693786034,3098,1604,40.0,,2.0,,301,81,288,13713,1839
2020-05-06,S92000003,Scotland,307,14020,256.49469447493595,37.449688986461766,43,1882,34.43102817416758,2989,60409,1105.1774606659349,5031,422,8.387994434506062,8.390216154721273,3180,1851,46.0,,2.0,,329,93,307,14020,1882
2020-05-07,S92000003,Scotland,297,14317,261.9282839370655,36.7178924259056,40,1922,35.16282473472375,2849,63258,1157.2996706915478,4910,394,8.024439918533604,8.267704083246356,3228,1682,37.0,,0.0,,313,81,297,14317,1922
2020-05-08,S92000003,Scotland,258,14575,266.6483717526528,34.577387486278816,34,1956,35.78485181119649,2799,66057,1208.507135016465,4799,344,7.168160033340279,8.012573774698486,3184,1615,33.0,,4.0,,261,83,258,14575,1956
2020-05-09,S92000003,Scotland,180,14755,269.9414562751556,33.80900109769484,34,1990,36.40687888766923,1916,67973,1243.5601902671058,3508,246,7.01254275940707,7.933597143132902,2114,1394,21.0,,1.0,,167,79,180,14755,1990
2020-05-10,S92000003,Scotland,153,14908,272.7405781192828,33.1686791072082,28,2018,36.91913648005855,1778,69751,1276.0885473838273,3203,212,6.618794879800187,7.916734428362335,1942,1261,28.0,,1.0,,156,56,153,14908,2018
2020-05-11,S92000003,Scotland,265,15173,277.58873033296743,31.979509696304422,32,2050,37.50457372850347,3213,72964,1334.8701061105012,5786,364,6.291047355686138,7.401609317761984,4183,1603,33.0,,2.0,,278,86,265,15173,2050
2020-05-12,S92000003,Scotland,230,15403,281.7965605561654,30.918404683497982,31,2081,38.071716062934506,2942,75906,1388.6937431394072,5413,326,6.022538333641235,7.068912710566616,3964,1449,37.0,,0.0,,257,69,230,15403,2081
2020-05-13,S92000003,Scotland,198,15601,285.41895353091843,28.92425905598244,42,2123,38.84010245151848,3318,79224,1449.3962678375412,5518,268,4.856832185574484,6.50028668859583,3670,1848,27.0,,0.0,,196,72,198,15601,2123
2020-05-14,S92000003,Scotland,211,15812,289.2791803878522,27.35089645078668,35,2158,39.48042444200512,3666,82890,1516.4654226125135,6194,293,4.730384242815628,5.964382208535487,4184,2010,28.0,,1.0,,218,75,211,15812,2158
2020-05-15,S92000003,Scotland,151,15963,292.0417124039517,25.39334065129893,26,2184,39.95609220636663,3028,85918,1571.862422246615,5354,238,4.445274561075832,5.566674290942361,3545,1809,34.0,,2.0,,172,66,151,15963,2184
2020-05-16,S92000003,Scotland,103,16066,293.9260885473838,23.98463227222832,29,2213,40.48664471276985,2208,88126,1612.2575923893155,3998,149,3.726863431715858,5.21626346359894,2232,1766,19.0,,0.0,,97,52,103,16066,2213
2020-05-17,S92000003,Scotland,93,16159,295.62751555067695,22.88693743139407,26,2239,40.96231247713136,1750,89876,1644.2736919136482,3487,130,3.728133065672498,4.945454545454545,2252,1235,10.0,,1.0,,83,47,93,16159,2239
2020-05-18,S92000003,Scotland,141,16300,298.2070984266374,20.61836809366996,23,2262,41.38309549945115,3515,93391,1708.5803146725211,6306,229,3.631462099587694,4.502343534601599,4413,1893,29.0,,1.0,,180,49,141,16300,2262
2020-05-19,S92000003,Scotland,182,16482,301.5367727771679,19.74021222100256,28,2290,41.89535309184047,3920,97311,1780.296377607025,6619,253,3.822329657047893,4.1626641050272175,3993,2626,14.0,,2.0,,191,62,182,16482,2290
2020-05-20,S92000003,Scotland,121,16603,303.75045737285035,18.331503841931944,22,2312,42.29784120014636,4040,101351,1854.207830223198,6621,187,2.824346775411569,3.833691904922367,4153,2468,19.0,,0.0,,138,49,121,16603,2312
2020-05-21,S92000003,Scotland,111,16714,305.7811928283937,16.50201244054153,24,2336,42.73691913648005,3322,104673,1914.983534577388,5943,171,2.8773346794548207,3.540492590273429,3957,1986,13.0,,0.0,,123,48,111,16714,2336
2020-05-22,S92000003,Scotland,91,16805,307.446030003659,15.404317599707282,17,2353,43.04793267471644,3045,107718,1970.6915477497253,5361,156,2.909904868494684,3.325942350332594,3538,1823,16.0,,1.0,,104,52,91,16805,2353
2020-05-23,S92000003,Scotland,50,16855,308.3607757043542,14.434687156970362,11,2364,43.24917672886937,1964,109682,2006.6227588730333,3843,104,2.706219099661723,3.22158198009429,2429,1414,14.0,,0.0,,70,34,50,16855,2364
2020-05-24,S92000003,Scotland,53,16908,309.3304061470911,13.702890596414198,8,2372,43.39553604098061,1959,111641,2042.462495426272,3733,96,2.571658183766408,3.112475927757248,2129,1604,8.0,,1.0,,57,39,53,16908,2372
2020-05-25,S92000003,Scotland,96,17004,311.0867178924259,12.879619465788512,14,2386,43.65166483717526,3003,114644,2097.402122210026,5658,155,2.7394839165782963,2.969982529514533,3968,1690,14.0,,1.0,,105,50,96,17004,2386
2020-05-26,S92000003,Scotland,478,17482,319.83168679107206,18.294914013904133,14,2400,43.90779363336992,4814,119458,2185.47383827296,8603,553,6.427990235964199,3.576278859212313,3867,4736,14.0,,0.0,,84,469,478,17482,2400
2020-05-27,S92000003,Scotland,66,17548,321.03915111598974,17.288693743139408,16,2416,44.20051225759239,2717,122175,2235.181119648738,5126,109,2.126414358174015,3.5121645281835527,3463,1663,11.0,,0.0,,84,25,66,17548,2416
2020-05-28,S92000003,Scotland,55,17603,322.0453713867545,16.264178558360776,16,2432,44.49323088181485,2583,124758,2282.436882546652,4942,105,2.1246458923512748,3.4293994525841245,3451,1491,7.0,,0.0,,69,36,55,17603,2432
2020-05-29,S92000003,Scotland,30,17633,322.5942188071716,15.148188803512625,11,2443,44.6944749359678,2187,126945,2322.44785949506,4431,61,1.3766644098397651,3.255724350506385,3166,1265,11.0,,0.0,,38,23,30,17633,2443
2020-05-30,S92000003,Scotland,40,17673,323.3260153677278,14.965239663373582,6,2449,44.804244420051226,1514,128459,2350.146359312111,3269,79,2.4166411746711534,3.238073933225212,2460,809,4.0,,0.0,,49,30,40,17673,2449
2020-05-31,S92000003,Scotland,23,17696,323.7467983900476,14.41639224295646,6,2455,44.914013904134656,1603,130062,2379.4731064764,3309,54,1.6319129646418855,3.1580734619955857,2489,820,11.0,,0.0,,37,17,23,17696,2455
2020-06-01,S92000003,Scotland,38,17734,324.44200512257595,13.35528723015002,3,2458,44.96889864617636,2287,132349,2421.3135748261984,4682,88,1.8795386586928664,3.052790873639485,3547,1135,6.0,,1.0,,65,23,38,17734,2458
2020-06-02,S92000003,Scotland,46,17780,325.28357116721554,5.451884376143432,6,2464,45.07866813025979,2566,134915,2468.2583241858765,5249,88,1.6765098113926462,1.8833849329205368,3951,1298,5.0,,1.0,,70,18,46,17780,2464
2020-06-03,S92000003,Scotland,34,17814,325.90559824368825,4.8664471276985,8,2472,45.22502744237102,2597,137512,2515.770215879985,5206,70,1.3446023818670765,1.7530880082346885,3688,1518,9.0,,1.0,,45,25,34,17814,2472
2020-06-04,S92000003,Scotland,35,17849,326.5459202341749,4.500548847420418,1,2473,45.24332235638492,2543,140055,2562.294182217344,5267,75,1.4239605088285552,1.639448635915067,3742,1525,8.0,,0.0,,69,6,35,17849,2473
2020-06-05,S92000003,Scotland,24,17873,326.9849981705086,4.390779363336993,9,2482,45.40797658251006,2665,142720,2611.050128064398,5050,50,0.99009900990099,1.5734265734265735,3395,1655,10.0,,0.0,,41,9,24,17873,2482
2020-06-06,S92000003,Scotland,22,17895,327.3874862788145,4.061470911086718,3,2485,45.462861324551774,1985,144705,2647.3655323819976,3836,39,1.0166840458811262,1.4233565446792846,2572,1264,6.0,,0.0,,27,12,22,17895,2485
2020-06-07,S92000003,Scotland,17,17912,327.69849981705084,3.951701427003293,7,2492,45.590925722649104,1579,146284,2676.253201609952,3384,28,0.8274231678486997,1.3405153945032748,2271,1113,7.0,,1.0,,14,14,17,17912,2492
2020-06-08,S92000003,Scotland,18,17930,328.02780826930115,3.5858031467252105,6,2498,45.70069520673253,2828,149112,2727.9912184412733,5728,64,1.11731843575419,1.2277580071174377,3900,1828,3.0,,0.0,,51,13,18,17930,2498
2020-06-09,S92000003,Scotland,27,17957,328.52177094767654,3.238199780461032,1,2499,45.71899012074643,3024,152136,2783.3150384193195,5980,69,1.153846153846154,1.1465559780557897,4249,1731,8.0,,0.0,,55,14,27,17957,2499
2020-06-10,S92000003,Scotland,29,17986,329.0523234540798,3.146725210391512,5,2504,45.81046469081596,3243,155379,2842.645444566411,6100,59,0.9672131147540984,1.086433724713538,3917,2183,8.0,,1.0,,49,10,29,17986,2504
2020-06-11,S92000003,Scotland,21,18007,329.43651664837176,2.890596414196853,2,2506,45.84705451884376,2812,158191,2894.0907427735087,6184,48,0.7761966364812419,0.984501682201754,4244,1940,7.0,,0.0,,42,6,21,18007,2506
2020-06-12,S92000003,Scotland,30,18037,329.9853640687889,3.000365898280278,2,2508,45.88364434687157,2917,161108,2947.457006952068,6028,46,0.7631055076310551,0.947905477980666,3936,2092,4.0,,0.0,,36,10,30,18037,2508
2020-06-13,S92000003,Scotland,22,18059,330.3878521770948,3.000365898280278,3,2511,45.93852908891328,1866,162974,2981.5953165020123,4101,34,0.8290660814435503,0.9278762831622452,2611,1490,6.0,,0.0,,26,8,22,18059,2511
2020-06-14,S92000003,Scotland,13,18072,330.6256860592755,2.927186242224661,4,2515,46.0117087449689,1643,164617,3011.653860226857,3717,24,0.645682001614205,0.909138960833025,2409,1308,6.0,,0.0,,15,9,13,18072,2515
2020-06-15,S92000003,Scotland,21,18093,331.00987925356753,2.982070984266374,3,2518,46.06659348701061,2874,167491,3064.233443102817,6204,45,0.7253384912959381,0.8482539019679489,4215,1989,7.0,,0.0,,37,8,21,18093,2518
2020-06-16,S92000003,Scotland,17,18110,331.3208927918039,2.7991218441273324,6,2524,46.17636297109404,2962,170453,3118.4229784120016,6702,30,0.4476275738585497,0.7326570345322266,4266,2436,6.0,,1.0,,23,7,17,18110,2524
2020-06-17,S92000003,Scotland,33,18143,331.9246249542627,2.872301500182949,3,2527,46.231247713135744,3258,173711,3178.027808269301,7235,49,0.6772633033863165,0.6870628065022031,3954,3281,6.0,,1.0,,38,11,33,18143,2527
2020-06-18,S92000003,Scotland,14,18157,332.18075375045737,2.74423710208562,3,2530,46.286132455177466,3060,176771,3234.010245151848,7281,35,0.480703200109875,0.6372976640496268,3715,3566,5.0,,0.0,,24,11,14,18157,2530
2020-06-19,S92000003,Scotland,24,18181,332.6198316867911,2.6344676180021955,0,2530,46.286132455177466,3034,179805,3289.517014270033,6812,39,0.5725190839694656,0.608770094169124,3618,3194,4.0,,0.0,,28,11,24,18181,2530
2020-06-20,S92000003,Scotland,6,18187,332.7296011708745,2.341748993779729,3,2533,46.34101719721917,1451,181256,3316.0629345042075,4026,10,0.2483854942871336,0.5526836124544393,2795,1231,2.0,,0.0,,5,5,6,18187,2533
2020-06-21,S92000003,Scotland,9,18196,332.89425539699965,2.268569337724113,2,2535,46.37760702524698,1344,182600,3340.651298938896,3358,16,0.4764740917212627,0.5382286510644433,2405,953,1.0,,0.0,,12,4,9,18196,2535
2020-06-22,S92000003,Scotland,10,18206,333.0772045371387,2.067325283571168,3,2538,46.432491767288695,3182,185782,3398.8657153311374,7219,31,0.4294223576672669,0.492576173386813,3882,3337,8.0,,0.0,,28,3,10,18206,2538
2020-06-23,S92000003,Scotland,20,18226,333.4431028174168,2.12221002561288,1,2539,46.4507866813026,4170,189952,3475.1555067691183,10258,30,0.2924546695262234,0.4546537054276992,4299,5959,6.0,,0.0,,16,14,20,18226,2539
2020-06-24,S92000003,Scotland,8,18234,333.589462129528,1.6648371752652764,1,2540,46.4690815953165,3690,193642,3542.6637394804243,9795,17,0.1735579377233282,0.3651356950911813,3783,6012,5.0,,0.0,,9,8,8,18234,2540
2020-06-25,S92000003,Scotland,19,18253,333.9370654957922,1.756311745334797,0,2540,46.4690815953165,3225,196867,3601.6648371752653,8990,34,0.3781979977753059,0.3507867929763367,3561,5429,3.0,,0.0,,23,11,19,18253,2540
2020-06-26,S92000003,Scotland,6,18259,334.0468349798756,1.427003293084523,0,2540,46.4690815953165,2962,199829,3655.8543724844494,8135,18,0.2212661339889367,0.3012688051601939,3318,4817,1.0,,0.0,,10,8,6,18259,2540
2020-06-27,S92000003,Scotland,4,18263,334.1200146359312,1.390413465056714,4,2544,46.54226125137212,1508,201337,3683.4431028174167,3936,10,0.2540650406504064,0.3017933489388868,2483,1453,4.0,,0.0,,7,3,4,18263,2544
2020-06-28,S92000003,Scotland,3,18266,334.17489937797296,1.2806439809732897,1,2545,46.56055616538602,1175,202512,3704.939626783754,3279,6,0.1829826166514181,0.282879950399132,2321,958,4.0,,0.0,,4,2,3,18266,2545
2020-06-29,S92000003,Scotland,14,18280,334.4310281741676,1.3538236370289058,1,2546,46.57885107939993,2988,205500,3759.6048298573,8448,22,0.2604166666666666,0.2592683711511894,3969,4479,3.0,,0.0,,14,8,14,18280,2546
2020-06-30,S92000003,Scotland,8,18288,334.57738748627884,1.1342846688620565,0,2546,46.57885107939993,3651,209151,3826.3995609220633,12223,19,0.1554446535220486,0.229901835565449,4030,8193,1.0,,0.0,,10,9,8,18288,2546
2020-07-01,S92000003,Scotland,11,18299,334.7786315404317,1.1891694109037687,0,2546,46.57885107939993,3538,212689,3891.1269667032566,11979,16,0.133567075715836,0.2193367257413581,3767,8212,2.0,,0.0,,8,8,11,18299,2546
2020-07-02,S92000003,Scotland,13,18312,335.0164654226125,1.079399926820344,0,2546,46.57885107939993,3037,215726,3946.688620563484,10378,17,0.1638080555020235,0.1850011990818459,3447,6931,2.0,,0.0,,5,12,13,18312,2546
2020-07-03,S92000003,Scotland,6,18318,335.1262349066959,1.079399926820344,1,2547,46.59714599341383,2829,218555,3998.444932308818,9122,10,0.1096250822188116,0.168449423060726,3374,5748,2.0,,0.0,,4,6,6,18318,2547
2020-07-04,S92000003,Scotland,5,18323,335.2177094767655,1.0976948408342482,0,2547,46.59714599341383,1612,220167,4027.936333699232,4369,8,0.183108262760357,0.1638850797685541,2520,1849,2.0,,0.0,,6,2,5,18323,2547
2020-07-05,S92000003,Scotland,2,18325,335.2542993047933,1.079399926820344,1,2548,46.61544090742774,1261,221428,4051.006220270765,3414,6,0.1757469244288224,0.1635159261174978,2448,966,2.0,,0.0,,6,0,2,18325,2548
2020-07-06,S92000003,Scotland,8,18333,335.4006586169045,0.9696304427369192,0,2548,46.61544090742774,2795,224223,4102.140504939627,8973,18,0.2006018054162487,0.1554798372423831,4020,4953,4.0,,0.0,,13,5,8,18333,2548
2020-07-07,S92000003,Scotland,11,18344,335.6019026710574,1.0245151847786316,0,2548,46.61544090742774,3206,227429,4160.793999268204,12551,12,0.0956099115608318,0.1431250616918369,4201,8350,2.0,,0.0,,1,11,11,18344,2548
2020-07-08,S92000003,Scotland,10,18354,335.78485181119646,1.0062202707647274,0,2548,46.61544090742774,3187,230616,4219.099890230516,13534,13,0.0960543815575587,0.1347427856466851,3586,9948,1.0,,1.0,,1,12,10,18354,2548
2020-07-09,S92000003,Scotland,8,18362,335.9312111233077,0.9147457006952068,0,2548,46.61544090742774,2981,233597,4273.637028905964,11869,11,0.0926784059314179,0.1221957638801854,3854,8015,1.0,,1.0,,2,9,8,18362,2548
2020-07-10,S92000003,Scotland,12,18374,336.1507500914745,1.0245151847786316,0,2548,46.61544090742774,2531,236128,4319.941456275155,8899,13,0.1460838296437802,0.1273404706881101,3471,5428,3.0,,0.0,,1,12,12,18374,2548
2020-07-11,S92000003,Scotland,9,18383,336.3154043175997,1.0976948408342482,0,2548,46.61544090742774,1606,237734,4349.323088181486,4479,12,0.2679169457468184,0.1333982014783659,2700,1779,3.0,,0.0,,8,4,9,18383,2548
2020-07-12,S92000003,Scotland,2,18385,336.3519941456275,1.0976948408342482,0,2548,46.61544090742774,1337,239071,4373.783388218076,3567,5,0.1401738155312587,0.1315130260521042,2429,1138,1.0,,0.0,,3,2,2,18385,2548
2020-07-13,S92000003,Scotland,18,18403,336.6813025978778,1.2806439809732897,0,2548,46.61544090742774,3014,242085,4428.924259055983,9704,24,0.2473206924979389,0.1393124158320821,4472,5232,1.0,,0.0,,8,16,18,18403,2548
2020-07-14,S92000003,Scotland,10,18413,336.86425173801683,1.262349066959385,0,2548,46.61544090742774,3414,245499,4491.383095499451,14817,13,0.0877370587838293,0.1360869760277557,4901,9916,2.0,,0.0,,3,10,10,18413,2548
2020-07-15,S92000003,Scotland,16,18429,337.1569703622393,1.37211855104281,0,2548,46.61544090742774,3078,248577,4547.694840834248,14011,20,0.1427449860823638,0.1455171799364476,4150,9861,1.0,,0.0,,3,17,16,18429,2548
2020-07-16,S92000003,Scotland,21,18450,337.5411635565313,1.609952433223564,0,2548,46.61544090742774,2725,251302,4597.548481522137,11860,23,0.193929173693086,0.1633574409314344,4280,7580,3.0,,0.0,,1,22,21,18450,2548
2020-07-17,S92000003,Scotland,8,18458,337.68752286864253,1.5367727771679471,0,2548,46.61544090742774,2556,253858,4644.310281741676,8946,10,0.1117818019226469,0.1587914044877122,3688,5258,2.0,,0.0,,4,6,8,18458,2548
2020-07-18,S92000003,Scotland,13,18471,337.92535675082325,1.609952433223564,0,2548,46.61544090742774,1389,255247,4669.721917306989,4089,16,0.3912937148447053,0.1656864793862137,2699,1390,1.0,,0.0,,5,11,13,18471,2548
2020-07-19,S92000003,Scotland,17,18488,338.23637028905966,1.8843761434321256,0,2548,46.61544090742774,1690,256937,4700.640321990487,4049,17,0.4198567547542604,0.182287035390361,2453,1596,2.0,,0.0,,3,14,17,18488,2548
2020-07-20,S92000003,Scotland,13,18501,338.4742041712404,1.7929015733626052,0,2548,46.61544090742774,3367,260304,4762.239297475302,10984,17,0.1547705753823743,0.1687125487230205,4967,6017,1.0,,0.0,,2,15,13,18501,2548
2020-07-21,S92000003,Scotland,19,18520,338.8218075375046,1.9575557994877424,0,2548,46.61544090742774,3327,263631,4823.106476399561,15045,22,0.1462279827185111,0.181201438014612,4946,10099,2.0,,0.0,,2,20,19,18520,2548
2020-07-22,S92000003,Scotland,16,18536,339.11452616172704,1.9575557994877424,0,2548,46.61544090742774,3344,266975,4884.284668862057,15129,25,0.1652455548945733,0.1854440672163419,4512,10617,2.0,,0.0,,7,18,16,18536,2548
2020-07-23,S92000003,Scotland,23,18559,339.5353091840468,1.9941456275155507,0,2548,46.61544090742774,3012,269987,4939.388949871935,12843,26,0.2024449116250097,0.1870999507631708,4196,8647,3.0,,0.0,,3,23,23,18559,2548
2020-07-24,S92000003,Scotland,11,18570,339.73655323819975,2.049030369557263,0,2548,46.61544090742774,2724,272711,4989.22429564581,9814,15,0.1528428775219074,0.1917918641335316,4066,5748,1.0,,0.0,,2,13,11,18570,2548
2020-07-25,S92000003,Scotland,3,18573,339.7914379802415,1.8660812294182216,1,2549,46.63373582144164,1608,274319,5018.642517380168,4383,5,0.1140771161305042,0.1757858457790635,2570,1813,4.0,,1.0,,1,4,3,18573,2549
2020-07-26,S92000003,Scotland,7,18580,339.91950237833885,1.68313208927918,0,2549,46.63373582144164,1588,275907,5047.694840834248,4176,8,0.1915708812260536,0.1630419764003647,2725,1451,0.0,,0.0,,1,7,7,18580,2549
2020-07-27,S92000003,Scotland,13,18593,340.1573362605196,1.68313208927918,0,2549,46.63373582144164,3111,279018,5104.610318331504,10710,16,0.1493930905695611,0.1622746185852981,5064,5646,4.0,,0.0,,2,14,13,18593,2549
2020-07-28,S92000003,Scotland,22,18615,340.55982436882545,1.7380168313208928,0,2549,46.63373582144164,3176,282194,5162.714965239664,15975,26,0.162754303599374,0.1656853347939203,4945,11030,0.0,,0.0,,3,23,22,18615,2549
2020-07-29,S92000003,Scotland,28,18643,341.0720819612148,1.9575557994877424,0,2549,46.63373582144164,3107,285301,5219.557263080864,15845,38,0.2398232881035026,0.1817047704282266,4290,11555,4.0,,0.0,,4,34,28,18643,2549
2020-07-30,S92000003,Scotland,27,18670,341.5660446395902,2.030735455543359,0,2549,46.63373582144164,2961,288262,5273.728503476033,13415,32,0.2385389489377562,0.1883796657606501,4485,8930,4.0,,0.0,,3,29,27,18670,2549
2020-07-31,S92000003,Scotland,21,18691,341.95023783388217,2.2136845956824005,0,2549,46.63373582144164,2737,290999,5323.801683132089,9743,23,0.236066919839885,0.1993346532519832,3980,5763,4.0,,0.0,,2,21,21,18691,2549
2020-08-01,S92000003,Scotland,22,18713,342.35272594218804,2.561287961946579,0,2549,46.63373582144164,1803,292802,5356.787413099159,4874,26,0.5334427574887156,0.2261232572453103,2692,2182,1.0,,0.0,,4,22,22,18713,2549
2020-08-02,S92000003,Scotland,19,18732,342.70032930845224,2.7808269301134283,0,2549,46.63373582144164,2095,294897,5395.115257958288,4773,19,0.3980724910957469,0.2389327669741819,2673,2100,2.0,,0.0,,0,19,19,18732,2549
2020-08-03,S92000003,Scotland,60,18792,343.7980241492865,3.640687888766923,0,2549,46.63373582144164,3659,298556,5462.0563483351625,12024,70,0.5821689953426481,0.3052877402183981,4946,7078,3.0,,0.0,,8,62,60,18792,2549
2020-08-04,S92000003,Scotland,57,18849,344.84083424807903,4.281009879253568,0,2549,46.63373582144164,4434,302990,5543.175997072814,17849,63,0.3529609501932881,0.3451218114437808,4984,12865,5.0,,0.0,,6,57,57,18849,2549
2020-08-05,S92000003,Scotland,64,18913,346.01170874496887,4.939626783754116,0,2549,46.63373582144164,4661,307651,5628.448591291621,18447,73,0.3957283027050469,0.3771956856702619,4900,13547,6.0,,0.0,,8,65,64,18913,2549
2020-08-06,S92000003,Scotland,62,18975,347.145993413831,5.579948774240761,0,2549,46.63373582144164,4118,311769,5703.787047200878,15929,73,0.4582836336242074,0.4148782266645942,4287,11642,2.0,,0.0,,7,66,62,18975,2549
2020-08-07,S92000003,Scotland,46,19021,347.98755945847057,6.0373216245883645,0,2549,46.63373582144164,3863,315632,5774.46030003659,12175,50,0.4106776180698152,0.4345249851866483,4445,7730,3.0,,0.0,,3,47,46,19021,2549
2020-08-08,S92000003,Scotland,27,19048,348.481522136846,6.128796194657886,0,2549,46.63373582144164,2252,317884,5815.660446395902,5591,28,0.5008048649615454,0.4332396183804213,2727,2864,3.0,,0.0,,4,24,27,19048,2549
2020-08-09,S92000003,Scotland,26,19074,348.95718990120747,6.256860592755214,0,2549,46.63373582144164,1872,319756,5849.908525429931,4702,36,0.7656316461080391,0.453198334813243,2645,2057,1.0,,0.0,,3,33,26,19074,2549
2020-08-10,S92000003,Scotland,57,19131,350.0,6.201975850713502,0,2549,46.63373582144164,4394,324150,5930.296377607025,13694,64,0.4673579669928435,0.4378471947232059,5431,8263,7.0,,0.0,,9,55,57,19131,2549
2020-08-11,S92000003,Scotland,64,19195,351.1708744968899,6.330040248810831,0,2549,46.63373582144164,4163,328313,6006.458104646908,18228,77,0.4224270353302611,0.4517495437442264,5151,13077,3.0,,0.0,,6,71,64,19195,2549
2020-08-12,S92000003,Scotland,48,19243,352.0490303695573,6.0373216245883645,0,2549,46.63373582144164,3660,331973,6073.417489937797,16788,57,0.3395282344531808,0.4419851447070844,4538,12250,2.0,,0.0,,3,54,48,19243,2549
2020-08-13,S92000003,Scotland,52,19295,353.0003658982803,5.854372484449323,0,2549,46.63373582144164,3480,335453,6137.083790706184,15116,72,0.4763164858428155,0.4449903817183118,4546,10570,3.0,,0.0,,9,63,52,19295,2549
2020-08-14,S92000003,Scotland,50,19345,353.9151115989755,5.92755214050494,0,2549,46.63373582144164,3853,339306,6207.574094401756,12294,62,0.504311046038718,0.45826438151667,4548,7746,7.0,,0.0,,7,55,50,19345,2549
2020-08-15,S92000003,Scotland,20,19365,354.2810098792536,5.79948774240761,0,2549,46.63373582144164,2509,341815,6253.476033662641,6163,30,0.4867759208177835,0.4575501523251135,2893,3270,7.0,,1.0,,4,26,20,19365,2549
2020-08-16,S92000003,Scotland,30,19395,354.8298572996707,5.872667398463227,0,2549,46.63373582144164,2609,344424,6301.207464324918,5861,37,0.6312915884661321,0.4526683608640406,2749,3112,2.0,,0.0,,3,34,30,19395,2549
2020-08-17,S92000003,Scotland,72,19467,356.1470911086718,6.1470911086717885,0,2549,46.63373582144164,5863,350287,6408.470545188438,15881,85,0.5352307789182041,0.4649566593971062,5319,10562,8.0,,0.0,,7,78,72,19467,2549
2020-08-18,S92000003,Scotland,77,19544,357.5557994877424,6.384924990852542,0,2549,46.63373582144164,6333,356620,6524.332235638492,21854,87,0.3980964583142674,0.4576561618612769,5804,16050,7.0,,0.0,,6,81,77,19544,2549
2020-08-19,S92000003,Scotland,91,19635,359.22063666300767,7.171606293450421,1,2550,46.65203073545554,6328,362948,6640.102451518477,21442,99,0.4617106613189068,0.4786484266461145,4896,16546,8.0,,0.0,,5,94,91,19635,2550
2020-08-20,S92000003,Scotland,140,19775,361.78192462495423,8.781558726673985,0,2550,46.65203073545554,7273,370221,6773.161361141602,20593,153,0.7429709124459768,0.5312812235800477,4746,15847,8.0,,0.0,,10,143,140,19775,2550
2020-08-21,S92000003,Scotland,90,19865,363.4284668862056,9.51335528723015,0,2550,46.65203073545554,7902,378123,6917.727771679473,18163,106,0.5836040301712272,0.5429395127186082,5027,13136,4.0,,0.0,,13,93,90,19865,2550
2020-08-22,S92000003,Scotland,47,19912,364.2883278448592,10.007317965605562,1,2551,46.67032564946945,5822,383945,7024.240761068423,10870,59,0.5427782888684453,0.5459429289053234,3177,7693,6.0,,0.0,,8,51,47,19912,2551
2020-08-23,S92000003,Scotland,65,19977,365.4774972557629,10.647639956092206,1,2552,46.68862056348335,6552,390497,7144.109037687523,11421,81,0.7092198581560284,0.5572930529677934,3133,8288,1.0,,0.0,,5,76,65,19977,2552
2020-08-24,S92000003,Scotland,60,20037,366.5751920965972,10.428100987925356,0,2552,46.68862056348335,12300,402797,7369.136480058544,24880,72,0.2893890675241157,0.5084234230748396,6090,18790,10.0,,1.0,,10,62,60,20037,2552
2020-08-25,S92000003,Scotland,69,20106,367.8375411635565,10.281741675814123,0,2552,46.68862056348335,11691,414488,7583.022319795096,29447,87,0.2954460556253608,0.480206993334113,6029,23418,11.0,,0.0,,13,74,69,20106,2552
2020-08-26,S92000003,Scotland,97,20203,369.6121478229052,10.391511159897547,0,2552,46.68862056348335,12483,426971,7811.397731430662,30096,113,0.375465178096757,0.4612634907541073,5799,24297,12.0,,0.0,,8,105,97,20203,2552
2020-08-27,S92000003,Scotland,99,20302,371.4233443102817,9.64141968532748,0,2552,46.68862056348335,11900,438871,8029.107208196122,24210,109,0.4502271788517141,0.4205598073608027,5204,19006,10.0,,1.0,,9,100,99,20302,2552
2020-08-28,S92000003,Scotland,104,20406,373.3260153677278,9.897548481522136,1,2553,46.706915477497255,10286,449157,8217.28869374314,21537,116,0.5386079769698658,0.4178117682554882,5054,16483,5.0,,1.0,,20,96,104,20406,2553
2020-08-29,S92000003,Scotland,95,20501,375.0640321990487,10.775704354189536,0,2553,46.706915477497255,6211,455368,8330.918404683498,11241,110,0.9785606262788008,0.4501675041876047,3176,8065,4.0,,0.0,,7,103,95,20501,2553
2020-08-30,S92000003,Scotland,102,20603,376.9301134284669,11.452616172703989,0,2553,46.706915477497255,5927,461295,8439.352360043908,10866,113,1.0399411006810233,0.4728225536358084,3242,7624,3.0,,0.0,,10,103,102,20603,2553
2020-08-31,S92000003,Scotland,144,20747,379.5645810464691,12.989388949871936,0,2553,46.706915477497255,10595,471890,8633.186974021222,23254,155,0.6665519910553024,0.5330200264186763,6430,16824,4.0,,1.0,,15,140,144,20747,2553
2020-09-01,S92000003,Scotland,199,20946,383.205268935236,15.367727771679473,0,2553,46.706915477497255,10401,482291,8823.472374679839,27409,214,0.7807654420080995,0.6257864386022758,6400,21009,4.0,,0.0,,34,180,199,20946,2553
2020-09-02,S92000003,Scotland,191,21137,386.6995975118917,17.087449688986464,1,2554,46.72521039151116,9931,492222,9005.15916575192,26178,203,0.7754603101841241,0.7049310618888005,5222,20956,9.0,,0.0,,12,191,191,21137,2554
2020-09-03,S92000003,Scotland,200,21337,390.3585803146725,18.93523600439078,1,2555,46.74350530552507,8661,500883,9163.611416026344,22294,219,0.9823270835202296,0.7914329138038507,5323,16971,4.0,,0.0,,13,206,200,21337,2555
2020-09-04,S92000003,Scotland,171,21508,393.48701061105015,20.16099524332236,1,2556,46.76180021953897,7152,508035,9294.456641053788,17487,195,1.1151140847486705,0.8714832515191488,5119,12368,17.0,,0.0,,22,173,171,21508,2556
2020-09-05,S92000003,Scotland,136,21644,395.9751189169411,20.911086717892427,0,2556,46.76180021953897,4519,512554,9377.13135748262,9327,148,1.5867910367749545,0.9114497679348024,3353,5974,9.0,,0.0,,8,140,136,21644,2556
2020-09-06,S92000003,Scotland,153,21797,398.7742407610685,21.844127332601538,0,2556,46.76180021953897,3857,516411,9447.694840834249,8054,165,2.0486714675937425,0.9693812825086006,3073,4981,8.0,,1.0,,10,155,153,21797,2556
2020-09-07,S92000003,Scotland,167,21964,401.8294914013904,22.26491035492133,0,2556,46.76180021953897,7906,524317,9592.334431028174,16543,198,1.1968808559511577,1.0542689249913584,6273,10270,16.0,,0.0,,35,163,167,21964,2556
2020-09-08,S92000003,Scotland,102,22066,403.6955726308087,20.49030369557263,0,2556,46.76180021953897,5258,529575,9688.529088913285,20278,115,0.5671170726896144,1.0344454523514286,6088,14190,14.0,,0.0,,21,94,102,22066,2556
2020-09-09,S92000003,Scotland,222,22288,407.75704354189537,21.057446030003657,0,2556,46.76180021953897,6353,535928,9804.756677643616,22641,243,1.073274148668345,1.100116614076005,5607,17034,8.0,,1.0,,18,225,222,22288,2556
2020-09-10,S92000003,Scotland,216,22504,411.70874496889866,21.350164654226123,0,2556,46.76180021953897,5567,541495,9906.60446395902,18645,262,1.4052024671493697,1.1737109980084088,5566,13079,20.0,,1.0,,31,231,216,22504,2556
2020-09-11,S92000003,Scotland,209,22713,415.53238199780463,22.04537138675448,0,2556,46.76180021953897,4647,546142,9991.620929381632,14282,243,1.7014423750175045,1.2517081169718502,5364,8918,20.0,,1.0,,25,218,209,22713,2556
2020-09-12,S92000003,Scotland,207,22920,419.3194291986828,23.34431028174168,0,2556,46.76180021953897,3490,549632,10055.470179290158,8131,236,2.902472020661665,1.3465470554644758,3338,4793,16.0,,1.0,,23,213,207,22920,2556
2020-09-13,S92000003,Scotland,166,23086,422.3563849249909,23.58214416392243,1,2557,46.78009513355288,3382,553014,10117.34357848518,7300,191,2.616438356164384,1.3800779076238174,3095,4205,12.0,,0.0,,11,180,166,23086,2557
2020-09-14,S92000003,Scotland,177,23263,425.5945847054519,23.76509330406148,3,2560,46.83497987559458,5375,558389,10215.678741309915,17016,199,1.1694875411377526,1.3749734516543082,6406,10610,19.0,,0.0,,38,161,177,23263,2560
2020-09-15,S92000003,Scotland,227,23490,429.7475301866081,26.05195755579949,0,2560,46.83497987559458,4931,563320,10305.890962312478,21047,258,1.2258279089656483,1.4963965450844474,6626,14421,20.0,,0.0,,33,225,227,23490,2560
2020-09-16,S92000003,Scotland,268,23758,434.65056714233447,26.89352360043908,0,2560,46.83497987559458,4423,567743,10386.809366995974,20120,305,1.5159045725646123,1.5899982166489894,5717,14403,34.0,,1.0,,45,260,268,23758,2560
2020-09-17,S92000003,Scotland,254,24012,439.297475301866,27.58873033296744,1,2561,46.85327478960848,4112,571855,10462.038053421147,15935,296,1.8575462817696893,1.6642428561797535,5215,10720,21.0,,1.0,,36,260,254,24012,2561
2020-09-18,S92000003,Scotland,269,24281,444.21880717160633,28.686425173801684,2,2563,46.8898646176363,3842,575697,10532.327113062567,13006,301,2.3143164693218514,1.7415045585295694,5351,7655,14.0,,3.0,,30,271,269,24281,2563
2020-09-19,S92000003,Scotland,232,24513,448.463227222832,29.143798024149287,0,2563,46.8898646176363,2647,578344,10580.753750457372,6881,258,3.749455021072518,1.7847095404965203,3217,3664,19.0,,0.0,,29,229,232,24513,2563
2020-09-20,S92000003,Scotland,315,24828,454.2261251372118,31.869740212221004,3,2566,46.94474935967801,2924,581268,10634.248079034029,7261,343,4.7238672359179175,1.935496612880928,3275,3986,19.0,,2.0,,31,312,315,24828,2566
2020-09-21,S92000003,Scotland,454,25282,462.5320160995244,36.93743139407245,2,2568,46.98133918770581,4829,586097,10722.594218807171,16238,483,2.974504249291785,2.233102459995223,6110,10128,28.0,,0.0,,76,407,454,25282,2568
2020-09-22,S92000003,Scotland,493,25775,471.55140870837903,41.80387852177095,2,2570,47.01792901573362,4789,590886,10810.20856201976,22076,529,2.3962674397535784,2.477417575381464,6624,15452,33.0,,1.0,,84,445,493,25775,2570
2020-09-23,S92000003,Scotland,567,26342,481.9246249542627,47.27405781192828,2,2572,47.05451884376144,4893,595779,10899.725576289791,21371,595,2.78414674091058,2.7294488556749186,5744,15627,27.0,,3.0,,72,523,567,26342,2572
2020-09-24,S92000003,Scotland,715,27057,495.0054884742041,55.7080131723381,2,2574,47.09110867178924,4576,600355,10983.443102817417,18064,741,4.102081488042515,3.098277357789069,5501,12563,35.0,,1.0,,55,686,715,27057,2574
2020-09-25,S92000003,Scotland,577,27634,505.5616538602269,61.34284668862057,1,2575,47.10940358580315,4060,604415,11057.720453713868,13717,619,4.512648538310126,3.378531929399288,4972,8745,35.0,,1.0,,59,560,577,27634,2575
2020-09-26,S92000003,Scotland,434,28068,513.5016465422613,65.0384193194292,2,2577,47.14599341383095,3001,607416,11112.623490669594,7934,474,5.97428787496849,3.5476884709500194,3477,4457,34.0,,3.0,,50,424,434,28068,2577
2020-09-27,S92000003,Scotland,357,28425,520.032930845225,65.80680570801317,2,2579,47.18258324185876,2840,610256,11164.58104646908,7224,401,5.55094130675526,3.603316326530612,3411,3813,34.0,,2.0,,54,347,357,28425,2579
2020-09-28,S92000003,Scotland,624,29049,531.4489571899012,68.91694109037688,3,2582,47.23746798390048,4561,614817,11248.0241492865,16211,677,4.176176670162236,3.786222876816421,5511,10700,45.0,,3.0,,99,578,624,29049,2582
2020-09-29,S92000003,Scotland,659,29708,543.505305525064,71.95389681668496,1,2583,47.25576289791438,5052,619869,11340.45005488474,23162,704,3.0394611864260423,3.9105522691604064,6924,16238,33.0,,2.0,,82,622,659,29708,2583
2020-09-30,S92000003,Scotland,794,30502,558.0314672521039,76.1068422978412,4,2587,47.32894255397,4743,624612,11427.22283205269,21769,846,3.8862602783775095,4.128385192587041,6095,15674,47.0,,4.0,,94,752,794,30502,2587
2020-10-01,S92000003,Scotland,778,31280,572.2649103549213,77.25942188071717,5,2592,47.42041712403952,4491,629103,11509.385290889131,19123,839,4.387386916278826,4.178119846069269,6195,12928,64.0,,2.0,,130,709,778,31280,2592
2020-10-02,S92000003,Scotland,817,32097,587.2118551042811,81.65020124405416,1,2593,47.43871203805342,4730,633833,11595.9202341749,15671,889,5.67289898538702,4.3476695411093305,5699,9972,54.0,,7.0,,113,776,817,32097,2593
2020-10-03,S92000003,Scotland,695,32792,599.9268203439443,86.42517380168313,3,2596,47.49359678009513,3713,637546,11663.849249908526,9717,771,7.934547699907379,4.542112210636357,3826,5891,46.0,,3.0,,85,686,695,32792,2596
2020-10-04,S92000003,Scotland,741,33533,613.4833516282473,93.45042078302232,3,2599,47.548481522136846,3877,641423,11734.778631540432,9788,788,8.05067429505517,4.776465900330039,3634,6154,46.0,,1.0,,83,705,741,33533,2599
2020-10-05,S92000003,Scotland,1098,34631,633.571167215514,102.12221002561289,2,2601,47.585071350164654,6608,648031,11855.67142334431,21043,1182,5.617069809437818,5.004448213647286,7382,13661,73.0,,3.0,,168,1014,1098,34631,2601
2020-10-06,S92000003,Scotland,1189,35820,655.3238199780461,111.81851445298209,4,2605,47.65825100622028,6094,654125,11967.160629345042,25363,1267,4.995465836060403,5.374201871417607,7425,17938,94.0,,0.0,,229,1038,1189,35820,2605
2020-10-07,S92000003,Scotland,1251,37071,678.2107574094402,120.17929015733624,9,2614,47.82290523234541,6060,660185,12078.0278082693,24646,1332,5.404528118153047,5.638566904133194,6739,17907,88.0,,5.0,,191,1141,1251,37071,2614
2020-10-08,S92000003,Scotland,1170,38241,699.6158068057081,127.35089645078668,11,2625,48.02414928649836,5709,665894,12182.47347237468,21448,1258,5.865348750466244,5.864062157335756,6489,14959,95.0,,3.0,,174,1084,1170,38241,2625
2020-10-09,S92000003,Scotland,1095,39336,719.6487376509331,132.436882546652,6,2631,48.13391877058178,5461,671355,12282.38199780461,16921,1190,7.03268128361208,6.040674495447001,5794,11127,81.0,,5.0,,215,975,1095,39336,2631
2020-10-10,S92000003,Scotland,938,40274,736.8093669959751,136.88254665203073,11,2642,48.33516282473472,3594,674949,12348.133918770582,9886,1043,10.55027311349383,6.243464115573802,3664,6222,75.0,,5.0,,153,890,938,40274,2642
2020-10-11,S92000003,Scotland,957,41231,754.3175997072814,140.834248079034,11,2653,48.53640687888767,3487,678436,12411.928283937066,9366,1053,11.242793081358103,6.4698887878575935,3332,6034,80.0,,4.0,,162,891,957,41231,2653
2020-10-12,S92000003,Scotland,1352,42583,779.0523234540798,145.4811562385657,8,2661,48.6827661909989,5999,684435,12521.679473106477,20839,1508,7.236431690580162,6.733920245351019,6905,13934,107.0,,9.0,,201,1307,1352,42583,2661
2020-10-13,S92000003,Scotland,1420,44003,805.0311013538236,149.7072813757775,12,2673,48.90230515916575,5805,690240,12627.88144895719,24920,1561,6.264044943820226,6.986862043647384,7425,17495,124.0,,9.0,,256,1305,1420,44003,2673
2020-10-14,S92000003,Scotland,1288,45291,828.5949506037322,150.38419319429198,6,2679,49.01207464324918,5631,695871,12730.900109769484,23677,1419,5.993157916965832,7.108620540387385,6290,17387,123.0,,5.0,,227,1192,1288,45291,2679
2020-10-15,S92000003,Scotland,1292,46583,852.2319795096963,152.6161727039883,16,2695,49.304793267471645,5131,701002,12824.771313574824,20280,1439,7.095660749506903,7.318351881419345,6342,13938,107.0,,11.0,,246,1193,1292,46583,2695
2020-10-16,S92000003,Scotland,1250,47833,875.1006220270766,155.45188437614345,20,2715,49.670691547749726,4912,705914,12914.635931211124,16076,1388,8.633988554366757,7.526150794920188,5545,10531,140.0,,8.0,,238,1150,1250,47833,2715
2020-10-17,S92000003,Scotland,854,48687,890.7244785949507,153.91511159897547,10,2725,49.85364068788876,3185,709099,12972.905232345409,8594,970,11.28694437979986,7.545736634559441,3198,5396,88.0,,3.0,,160,810,854,48687,2725
2020-10-18,S92000003,Scotland,832,49519,905.9458470545188,151.62824734723748,22,2747,50.25612879619466,2678,711777,13021.899012074642,7674,925,12.053687776909044,7.545469441258397,3193,4481,88.0,,7.0,,172,753,832,49519,2747
2020-10-19,S92000003,Scotland,1354,50873,930.717160629345,151.66483717526526,16,2763,50.548847420417125,5382,717159,13120.362239297476,19880,1535,7.721327967806841,7.627517526692595,6948,12932,140.0,,12.0,,294,1241,1354,50873,2763
2020-10-20,S92000003,Scotland,1688,52561,961.5989754848152,156.56787413099158,19,2782,50.89645078668131,6073,723232,13231.467252103916,26283,1856,7.061598752045048,7.783511889208257,7976,18307,138.0,,3.0,,319,1537,1688,52561,2782
2020-10-21,S92000003,Scotland,1578,54139,990.468349798756,161.87339919502378,11,2793,51.09769484083424,5619,728851,13334.26637394804,23938,1728,7.218648174450664,8.018741087797922,6335,17603,132.0,,8.0,,305,1423,1578,54139,2793
2020-10-22,S92000003,Scotland,1491,55630,1017.7460665934872,165.5140870837907,17,2810,51.40870837907061,5268,734119,13430.64398097329,20910,1661,7.943567670970827,8.157756069879616,6592,14318,136.0,,9.0,,345,1316,1491,55630,2810
2020-10-23,S92000003,Scotland,1280,56910,1041.1635565312845,166.06293450420782,18,2828,51.7380168313209,4979,739098,13521.73435784852,17200,1420,8.255813953488373,8.109801653290917,6182,11018,131.0,,7.0,,262,1158,1280,56910,2828
2020-10-24,S92000003,Scotland,948,57858,1058.507135016465,167.78265642151482,20,2848,52.10391511159898,3416,742514,13584.229784120014,9886,1102,11.147076674084564,8.131445245724372,3774,6112,119.0,,9.0,,203,899,948,57858,2848
2020-10-25,S92000003,Scotland,937,58795,1075.6494694474936,169.70362239297475,23,2871,52.52469813391877,3263,745777,13643.926088547383,9034,1067,11.810936462253707,8.156153888508703,3557,5477,114.0,,10.0,,237,830,937,58795,2871
2020-10-26,S92000003,Scotland,1344,60139,1100.237833882181,169.5206732528357,31,2902,53.0918404683498,6007,751784,13753.823637028903,22064,1515,6.866388687454678,8.002938560878475,7976,14088,139.0,,9.0,,312,1203,1344,60139,2902
2020-10-27,S92000003,Scotland,1301,61440,1124.03951701427,162.4405415294548,16,2918,53.38455909257227,5304,757088,13850.859860958652,24871,1481,5.95472638816292,7.798096995379311,8185,16686,137.0,,8.0,,393,1088,1301,61440,2918
2020-10-28,S92000003,Scotland,1265,62705,1147.1825832418588,156.7142334431028,29,2947,53.915111598975486,4809,761897,13938.84010245152,23407,1458,6.228905882855556,7.618628898030964,7050,16357,131.0,,2.0,,347,1111,1265,62705,2947
2020-10-29,S92000003,Scotland,1096,63801,1167.2338090010976,149.48774240761068,29,2976,54.445664105378704,4503,766400,14021.22210025613,19969,1271,6.364865541589464,7.366864139332916,6949,13020,103.0,,7.0,,276,995,1096,63801,2976
2020-10-30,S92000003,Scotland,1089,64890,1187.1569703622392,145.993413830955,35,3011,55.085986095865344,4236,770636,14098.719356019026,16070,1252,7.790914747977598,7.299223469884517,6474,9596,132.0,,10.0,,276,976,1089,64890,3011
2020-10-31,S92000003,Scotland,741,65631,1200.7135016465422,142.20636663007684,24,3035,55.52506403219905,2755,773391,14149.121844127332,8474,857,10.113287703563842,7.18465723349127,3877,4597,105.0,,5.0,,224,633,741,65631,3035
2020-11-01,S92000003,Scotland,969,66600,1218.441273326015,142.79180387852176,35,3070,56.165386022685695,3139,776530,14206.54957921698,8813,1126,12.77658005219562,7.245204903451176,3521,5292,105.0,,11.0,,249,877,969,66600,3070
2020-11-02,S92000003,Scotland,1474,68074,1245.4079765825102,145.1701427003293,29,3099,56.69593852908891,6272,782802,14321.295279912183,22717,1673,7.364528767002685,7.334239589449893,8075,14642,113.0,,8.0,,362,1311,1474,68074,3099
2020-11-03,S92000003,Scotland,1388,69462,1270.801317233809,146.76180021953897,35,3134,57.33626051957556,5895,788697,14429.14379802415,26746,1614,6.034547222014506,7.3306602427969185,8631,18115,118.0,,13.0,,419,1195,1388,69462,3134
2020-11-04,S92000003,Scotland,1300,70762,1294.5847054518845,147.40212221002562,19,3153,57.683863885839735,5495,794192,14529.674350530551,25003,1494,5.975282966044074,7.267278076874922,7741,17262,125.0,,5.0,,311,1183,1300,70762,3153
2020-11-05,S92000003,Scotland,1290,72052,1318.1851445298207,150.951335528723,41,3194,58.43395536040981,5357,799549,14627.680204903038,22018,1521,6.907984376419293,7.345137514344467,7500,14518,101.0,,6.0,,366,1155,1290,72052,3194
2020-11-06,S92000003,Scotland,1131,73183,1338.8766922795462,151.719721917307,27,3221,58.927918038785215,5064,804613,14720.325649469449,18124,1334,7.3604060913705585,7.292922400394253,7143,10981,99.0,,7.0,,294,1040,1131,73183,3221
2020-11-07,S92000003,Scotland,837,74020,1354.189535309184,153.47603366264178,37,3258,59.60482985729967,3402,808015,14782.564946944747,9826,976,9.932831263993489,7.308232080271976,4004,5822,88.0,,5.0,,193,783,837,74020,3258
2020-11-08,S92000003,Scotland,873,74893,1370.1609952433223,151.719721917307,36,3294,60.26344676180022,3031,811046,14838.016831320894,9076,1001,11.029087703834287,7.200209722118194,3693,5383,81.0,,7.0,,233,768,873,74893,3294
2020-11-09,S92000003,Scotland,1295,76188,1393.8529088913283,148.44493230881815,42,3336,61.0318331503842,6088,817134,14949.396267837545,22873,1492,6.522974686311371,7.056394296230904,8647,14226,103.0,,4.0,,409,1083,1295,76188,3336
2020-11-10,S92000003,Scotland,1285,77473,1417.361873399195,146.560556165386,36,3372,61.69045005488474,5651,822785,15052.780826930111,26678,1448,5.4276932303770895,6.935732570846868,9122,17556,107.0,,5.0,,329,1119,1285,77473,3372
2020-11-11,S92000003,Scotland,1246,78719,1440.1573362605195,145.5726308086352,37,3409,62.36736187339919,5396,828181,15151.50018294914,25377,1438,5.6665484493833,6.874570805840026,8691,16686,115.0,,9.0,,339,1099,1246,78719,3409
2020-11-12,S92000003,Scotland,1194,79913,1462.0014635931211,143.8163190633004,32,3441,62.95279912184412,5031,833212,15243.541895353092,21064,1358,6.447018609950626,6.801335157647836,7519,13545,112.0,,8.0,,304,1054,1194,79913,3441
2020-11-13,S92000003,Scotland,1053,80966,1481.266008049762,142.38931577021586,38,3479,63.64800585437248,5081,838293,15336.49835345774,17599,1254,7.12540485254844,6.767904719494615,6972,10627,109.0,,6.0,,273,981,1053,80966,3479
2020-11-14,S92000003,Scotland,903,81869,1497.7863154043175,143.59678009513354,41,3520,64.39809732894255,4088,842381,15411.287961946578,11557,1079,9.336332958380202,6.757360829657885,4383,7174,100.0,,11.0,,253,826,903,81869,3520
2020-11-15,S92000003,Scotland,812,82681,1512.6417855836078,142.4807903402854,34,3554,65.0201244054153,3525,845906,15475.777533845592,9943,963,9.685205672332293,6.6858636030527565,3881,6062,95.0,,8.0,,219,744,812,82681,3554
2020-11-16,S92000003,Scotland,1273,83954,1535.9312111233075,142.0783022319795,33,3587,65.62385656787413,6393,852299,15592.73691913648,23803,1473,6.18829559299248,6.626182721785606,9097,14706,95.0,,6.0,,379,1094,1273,83954,3587
2020-11-17,S92000003,Scotland,1224,85178,1558.3241858763265,140.96231247713135,36,3623,66.28247347237468,6430,858729,15710.373216245884,28538,1429,5.007358609573201,6.523016224135306,9916,18622,111.0,,4.0,,430,999,1224,85178,3623
2020-11-18,S92000003,Scotland,1110,86288,1578.63154043176,138.4742041712404,24,3647,66.72155140870838,5789,864518,15816.282473472373,25883,1276,4.929876753081173,6.382102365106548,9118,16765,97.0,,8.0,,305,971,1110,86288,3647
2020-11-19,S92000003,Scotland,980,87268,1596.560556165386,134.55909257226492,25,3672,67.17892425905599,4980,869498,15907.391145261618,20409,1172,5.742564554853251,6.277408300177155,7062,13347,97.0,,5.0,,320,852,980,87268,3672
2020-11-20,S92000003,Scotland,858,88126,1612.2575923893155,130.99158433955358,29,3701,67.7094767654592,4563,874061,15990.87083790706,17432,1049,6.0176686553464895,6.136008432377422,7190,10242,110.0,,10.0,,292,757,858,88126,3701
2020-11-21,S92000003,Scotland,762,88888,1626.1983168679103,128.41200146359313,33,3734,68.31320892791804,3078,877139,16047.18258324186,10072,895,8.886020651310563,6.067754262198707,4001,6071,87.0,,4.0,,249,646,762,88888,3734
2020-11-22,S92000003,Scotland,706,89594,1639.1145261617269,126.4727405781193,36,3770,68.97182583241859,3060,880199,16103.165020124405,9112,865,9.49297629499561,6.0325769506613725,3682,5430,68.0,,2.0,,204,661,706,89594,3770
2020-11-23,S92000003,Scotland,1153,90747,1660.2085620197586,124.27735089645078,31,3801,69.53896816684961,5789,885988,16209.074277350895,22966,1381,6.013236958982844,6.001696277118115,9159,13807,107.0,,8.0,,346,1035,1153,90747,3801
2020-11-24,S92000003,Scotland,990,91737,1678.3205268935235,119.99634101719722,30,3831,70.08781558726673,5566,891554,16310.903768752283,26749,1171,4.377733747055965,5.888118953725975,9516,17233,105.0,,12.0,,326,845,990,91737,3831
2020-11-25,S92000003,Scotland,929,92666,1695.3165020124404,116.68496158068056,32,3863,70.67325283571166,4939,896493,16401.262349066958,24130,1095,4.537919602154994,5.828684954535035,8438,15692,86.0,,6.0,,250,845,929,92666,3863
2020-11-26,S92000003,Scotland,799,93465,1709.93413830955,113.37358214416392,23,3886,71.09403585803148,5094,901587,16494.45664105379,20740,971,4.681774349083896,5.660780024542496,7523,13217,104.0,,8.0,,248,723,799,93465,3886
2020-11-27,S92000003,Scotland,735,94200,1723.3809001097693,111.12330772045372,24,3910,71.53311379436516,4858,906445,16583.333333333332,17188,911,5.300209448452408,5.565949128339836,7397,9791,92.0,,7.0,,259,652,735,94200,3910
2020-11-28,S92000003,Scotland,571,94771,1733.8272960117088,107.62897914379803,41,3951,72.28320526893525,3151,909596,16640.980607391146,9829,693,7.0505646556109465,5.421760484722372,4153,5676,63.0,,3.0,,161,532,571,94771,3951
2020-11-29,S92000003,Scotland,555,95326,1743.9809732894255,104.8664471276985,28,3979,72.79546286132455,2895,912491,16693.9443834614,8442,672,7.960199004975125,5.301282642797823,3559,4883,69.0,,4.0,,165,507,555,95326,3979
2020-11-30,S92000003,Scotland,972,96298,1761.7636297109402,101.55506769118185,32,4011,73.38090010976948,6873,919364,16819.68532747896,24479,1140,4.657052984190531,5.057123528204505,9481,14998,88.0,,6.0,,335,805,972,96298,4011
2020-12-01,S92000003,Scotland,923,97221,1778.649835345774,100.32930845225026,27,4038,73.8748627881449,6333,925697,16935.547017929013,27808,1089,3.916139240506329,4.954907401821802,9650,18158,84.0,,6.0,,325,764,923,97221,4038
2020-12-02,S92000003,Scotland,948,98169,1795.9934138309552,100.67691181851448,20,4058,74.24076106842298,6029,931726,17045.847054518847,26054,1118,4.291087740845936,4.901144640998959,8905,17149,102.0,,5.0,,329,789,948,98169,4058
2020-12-03,S92000003,Scotland,803,98972,1810.68422978412,100.75009147457008,36,4094,74.89937797292353,5226,936952,17141.456275155506,20640,962,4.660852713178294,4.898095804819994,7229,13411,75.0,,4.0,,251,711,803,98972,4094
2020-12-04,S92000003,Scotland,646,99618,1822.502744237102,99.1218441273326,29,4123,75.42993047932676,4667,941619,17226.838638858397,17262,792,4.588112617309697,4.806934594168637,7326,9936,86.0,,5.0,,230,562,646,99618,4123
2020-12-05,S92000003,Scotland,662,100280,1834.6139773143068,100.78668130259788,19,4142,75.77753384559092,3735,945354,17295.170142700328,10211,781,7.648614239545588,4.858557703712489,3745,6466,78.0,,3.0,,176,605,662,100280,4142
2020-12-06,S92000003,Scotland,643,100923,1846.3776070252468,102.39663373582144,29,4171,76.30808635199415,3415,948769,17357.64727405781,9893,747,7.550793490346709,4.861859813563921,4055,5838,66.0,,1.0,,180,567,643,100923,4171
2020-12-07,S92000003,Scotland,949,101872,1863.7394804244416,101.97585071350164,29,4200,76.83863885839736,6136,954905,17469.904866447127,24395,1104,4.525517524082804,4.838437433492585,10029,14366,92.0,,5.0,,303,801,949,101872,4200
2020-12-08,S92000003,Scotland,1040,102912,1882.7661909989024,104.11635565312842,28,4228,77.35089645078668,5730,960635,17574.7347237468,28025,1190,4.246208742194469,4.90474794841735,10285,17740,105.0,,7.0,,326,864,1040,102912,4228
2020-12-09,S92000003,Scotland,996,103908,1900.9879253567508,104.99451152579584,23,4251,77.77167947310647,5153,965788,17669.008415660446,24867,1160,4.664816825511722,4.978823738109141,8734,16133,97.0,,3.0,,298,862,996,103908,4251
2020-12-10,S92000003,Scotland,891,104799,1917.2886937431392,106.60446395901938,23,4274,78.19246249542627,4505,970293,17751.427003293087,20203,1038,5.1378508142355095,5.051313994186391,7443,12760,94.0,,7.0,,274,764,891,104799,4274
2020-12-11,S92000003,Scotland,864,105663,1933.0954994511528,110.5927552140505,20,4294,78.55836077570436,4454,974747,17832.912550311015,17872,1015,5.679274843330349,5.1931850058317215,7699,10173,92.0,,5.0,,218,797,864,105663,4294
2020-12-12,S92000003,Scotland,677,106340,1945.4811562385653,110.86717892425906,23,4317,78.97914379802414,3293,978040,17893.1577021588,10120,772,7.628458498023716,5.190027700831025,4116,6004,69.0,,3.0,,131,641,677,106340,4317
2020-12-13,S92000003,Scotland,720,107060,1958.653494328577,112.27588730332968,26,4343,79.45481156238566,3278,981318,17953.12843029638,9838,824,8.375686115064038,5.24903931421815,3971,5867,70.0,,4.0,,177,647,720,107060,4343
2020-12-14,S92000003,Scotland,1083,108143,1978.4668862056349,114.7274057811928,31,4374,80.02195389681668,5669,986987,18056.8422978412,24158,1253,5.186687639705274,5.368551187047963,9888,14270,93.0,,6.0,,322,931,1083,108143,4374
2020-12-15,S92000003,Scotland,1033,109176,1997.3655323819976,114.5993413830955,32,4406,80.60739114526162,5544,992531,18158.269301134285,27802,1170,4.208330335947054,5.362598250037076,10007,17795,84.0,,8.0,,255,915,1033,109176,4406
2020-12-16,S92000003,Scotland,1028,110204,2016.172703988292,115.18477863154044,31,4437,81.17453347969264,5236,997767,18254.06147091109,24815,1176,4.739069111424541,5.376535517179989,8679,16136,112.0,,6.0,,310,866,1028,110204,4437
2020-12-17,S92000003,Scotland,911,111115,2032.839370654958,115.55067691181851,36,4473,81.8331503841932,4921,1002688,18344.090742773507,21198,1043,4.920275497688461,5.340824576776655,7618,13580,98.0,,5.0,,287,756,911,111115,4473
2020-12-18,S92000003,Scotland,920,112035,2049.67069154775,116.57519209659716,23,4496,82.25393340651299,5090,1007778,18437.21185510428,18643,1064,5.707235959877703,5.346552052367215,7309,11334,88.0,,8.0,,275,789,920,112035,4496
2020-12-19,S92000003,Scotland,747,112782,2063.3369923161363,117.85583607757044,27,4523,82.74789608488841,3994,1011772,18510.28174167581,11629,888,7.6360822082724225,5.372131254390475,4341,7288,94.0,,8.0,,234,654,747,112782,4523
2020-12-20,S92000003,Scotland,812,113594,2078.1924624954263,119.53896816684964,29,4552,83.27844859129162,4401,1016173,18590.797658251005,13112,950,7.245271507016474,5.336842179729338,4365,8747,70.0,,4.0,,201,749,812,113594,4552
2020-12-21,S92000003,Scotland,1304,114898,2102.049030369557,123.58214416392244,25,4577,83.73582144163923,6900,1023073,18717.032564946945,30734,1512,4.919632979761827,5.2746851615258254,11081,19653,107.0,,10.0,,390,1122,1304,114898,4577
2020-12-22,S92000003,Scotland,1326,116224,2126.308086351994,128.94255396999634,28,4605,84.24807903402854,6640,1029713,18838.51079399927,32415,1500,4.627487274409996,5.3315065619550825,9241,23174,104.0,,3.0,,303,1197,1326,116224,4605
2020-12-23,S92000003,Scotland,1313,117537,2150.32930845225,134.156604463959,35,4640,84.88840102451519,5844,1035557,18945.426271496523,27703,1504,5.429014908132693,5.4434679671114425,8336,19367,105.0,,6.0,,265,1239,1313,117537,4640
2020-12-24,S92000003,Scotland,1017,118554,2168.935236004391,136.09586534943284,36,4676,85.54701792901574,3355,1038912,19006.805708013173,13951,1140,8.171457243208371,5.775135470722804,4742,9209,95.0,,1.0,,205,935,1017,118554,4676
2020-12-25,S92000003,Scotland,515,119069,2178.3571167215514,128.6864251738017,35,4711,86.18733991950238,1201,1040113,19028.77789974387,4510,598,13.259423503325944,6.036373401763469,2367,2143,78.0,,5.0,,122,476,515,119069,4711
2020-12-26,S92000003,Scotland,1050,120119,2197.566776436151,134.22978412001464,34,4745,86.80936699597513,2642,1042755,19077.11306256861,8945,1176,13.147009502515372,6.378929740427799,3905,5040,109.0,,7.0,,230,946,1050,120119,4745
2020-12-27,S92000003,Scotland,1681,121800,2228.3205268935235,150.12806439809734,34,4779,87.43139407244786,3733,1046488,19145.407976582508,13378,1867,13.955748243384662,7.062657631650916,5066,8312,142.0,,8.0,,287,1580,1681,121800,4779
2020-12-28,S92000003,Scotland,1804,123604,2261.3245517746063,159.27552140504935,31,4810,87.99853640687888,3902,1050390,19216.794731064765,20659,1990,9.632605644029235,8.041230328806114,8654,12005,155.0,,11.0,,406,1584,1804,123604,4810
2020-12-29,S92000003,Scotland,3133,126737,2318.642517380168,192.33443102817412,26,4836,88.47420417124039,5835,1056225,19323.54555433589,35114,3356,9.557441476334226,9.36021245774988,10824,24290,156.0,,12.0,,466,2890,3133,126737,4836
2020-12-30,S92000003,Scotland,2963,129700,2372.850347603366,222.521039151116,32,4868,89.05964141968532,6194,1062419,19436.864251738018,31401,3192,10.165281360466228,10.408884165116678,9704,21697,192.0,,7.0,,451,2741,2963,129700,4868
2020-12-31,S92000003,Scotland,2374,132074,2416.2824734723745,247.3472374679839,44,4912,89.86461763629711,5097,1067516,19530.113428466884,18720,2612,13.952991452991451,11.143927008069197,6167,12553,173.0,,9.0,,409,2203,2374,132074,4912
2021-01-01,S92000003,Scotland,1159,133233,2437.4862788144897,259.12916209293815,35,4947,90.50493962678377,2130,1069646,19569.0815953165,8394,1275,15.18942101501072,11.322660693501987,3714,4680,135.0,,14.0,,228,1047,1159,133233,4947
2021-01-02,S92000003,Scotland,2211,135444,2477.9363336992315,280.3695572630809,42,4989,91.27332601536772,4524,1074170,19651.847786315404,15245,2400,15.74286651361102,11.679996641266245,4824,10421,153.0,,9.0,,328,2072,2211,135444,4989
2021-01-03,S92000003,Scotland,2218,137662,2518.514452982071,290.1939260885474,42,5031,92.0417124039517,5002,1079172,19743.35894621296,17058,2390,14.01102122171415,11.743558608645824,6116,10942,137.0,,10.0,,393,1997,2218,137662,5031
2021-01-04,S92000003,Scotland,2376,140038,2561.983168679107,300.65861690450055,37,5068,92.71862422246616,5097,1084269,19836.608122941823,24450,2644,10.813905930470348,11.882406139032597,9175,15275,187.0,,12.0,,537,2107,2376,140038,5068
2021-01-05,S92000003,Scotland,3050,143088,2617.7826564215147,299.1401390413465,40,5108,93.45042078302232,7337,1091606,19970.83790706184,37296,3420,9.16988416988417,11.754411263469756,12055,25241,195.0,,17.0,,718,2702,3050,143088,5108
2021-01-06,S92000003,Scotland,2548,145636,2664.398097328942,291.5477497255763,48,5156,94.32857665568972,6467,1098073,20089.15111598976,30395,2899,9.53775291988814,11.639108460127476,10813,19582,200.0,,13.0,,581,2318,2548,145636,5156
2021-01-07,S92000003,Scotland,2197,147833,2704.59202341749,288.3095499451153,44,5200,95.13355287230152,6021,1104094,20199.30479326747,25211,2646,10.495418666455118,11.182607925390228,9253,15958,204.0,,18.0,,774,1872,2197,147833,5200
2021-01-08,S92000003,Scotland,1823,149656,2737.943651664837,300.4573728503476,42,5242,95.90193926088548,5439,1109533,20298.810830589096,21495,2230,10.374505698999767,10.88460414840783,8920,12575,198.0,,11.0,,582,1648,1823,149656,5242
2021-01-09,S92000003,Scotland,1497,151153,2765.331137943652,287.39480424442,38,5280,96.59714599341385,3933,1113466,20370.76472740578,13711,1752,12.778061410546275,10.601004622205451,5538,8173,182.0,,21.0,,422,1330,1497,151153,5280
2021-01-10,S92000003,Scotland,1423,152576,2791.364800585437,272.8503476033663,59,5339,97.6765459202342,3696,1117162,20438.38272960117,13424,1662,12.380810488676996,10.394500608499715,6021,7403,168.0,,15.0,,444,1218,1423,152576,5339
2021-01-11,S92000003,Scotland,2087,154663,2829.546286132455,267.563117453348,48,5387,98.55470179290155,5952,1123114,20547.27405781193,29253,2381,8.139336136464637,9.948180460813305,12145,17108,241.0,,9.0,,606,1775,2087,154663,5387
2021-01-12,S92000003,Scotland,1977,156640,2865.715331137944,247.93267471642883,51,5438,99.48774240761068,4924,1128038,20637.358214416392,31065,2410,7.757926927410269,9.711097876684857,12951,18114,211.0,,16.0,,756,1654,1977,156640,5438
2021-01-13,S92000003,Scotland,1712,158352,2897.0362239297474,232.63812660080487,51,5489,100.4207830223198,4676,1132714,20722.905232345405,25123,2097,8.34693308920113,9.52901143883176,10533,14590,180.0,,16.0,,625,1472,1712,158352,5489
2021-01-14,S92000003,Scotland,1620,159972,2926.6739846322725,222.0819612147823,58,5547,101.48188803512625,4183,1136897,20799.43285766557,20739,1996,9.624379188967644,9.384406692074156,8608,12131,204.0,,19.0,,530,1466,1620,159972,5547
2021-01-15,S92000003,Scotland,1535,161507,2954.756677643615,216.8130259787779,58,5605,102.54299304793268,4623,1141520,20884.01024515185,20018,1820,9.091817364372066,9.207411320459393,9322,10696,184.0,,13.0,,472,1348,1535,161507,5605
2021-01-16,S92000003,Scotland,1176,162683,2976.271496523966,210.9403585803147,76,5681,103.9334065129894,3239,1144759,20943.267471642885,12466,1392,11.16637253329055,9.046078586081745,5858,6608,170.0,,17.0,,347,1045,1176,162683,5681
2021-01-17,S92000003,Scotland,1199,163882,2998.207098426637,206.8422978412001,43,5724,104.72008781558728,2830,1147589,20995.04207830223,11206,1446,12.903801534892024,9.03583105357977,5540,5666,160.0,,15.0,,410,1036,1199,163882,5724
2021-01-18,S92000003,Scotland,1735,165617,3029.948774240761,200.4024881083059,63,5787,105.87266739846322,5298,1152887,21091.96853274789,28889,2064,7.144587905431132,8.845798830816154,14622,14267,175.0,,19.0,,557,1507,1735,165617,5787
2021-01-19,S92000003,Scotland,1548,167165,3058.269301134285,192.553969996341,70,5857,107.15331137943652,5026,1157913,21183.91877058178,30016,1831,6.100079957356077,8.518291491812443,14564,15452,197.0,,15.0,,517,1314,1548,167165,5857
2021-01-20,S92000003,Scotland,1572,168737,3087.028905964142,189.99268203439445,66,5923,108.36077570435418,4428,1162341,21264.928649835347,24796,1876,7.565736409098242,8.387902518058462,12386,12410,184.0,,17.0,,565,1311,1572,168737,5923
2021-01-21,S92000003,Scotland,1240,169977,3109.714599341383,183.04061470911088,57,5980,109.40358580314673,4401,1166742,21345.444566410537,21363,1598,7.480222815147686,8.085160735173508,10054,11309,194.0,,17.0,,538,1060,1240,169977,5980
2021-01-22,S92000003,Scotland,1228,171205,3132.1807537504574,177.4240761068423,68,6048,110.6476399560922,4146,1170888,21421.295279912185,18943,1470,7.760122472681201,7.907014538289127,9975,8968,170.0,,8.0,,434,1036,1228,171205,6048
2021-01-23,S92000003,Scotland,936,172141,3149.304793267472,173.0332967435053,53,6101,111.61727039882912,3392,1174280,21483.351628247347,11624,1109,9.540605643496216,7.75962461777345,5070,6554,147.0,,7.0,,305,804,936,172141,6101
2021-01-24,S92000003,Scotland,857,172998,3164.983534577388,166.7764361507501,70,6171,112.8979143798024,2961,1177241,21537.52286864252,10712,984,9.185959671396564,7.4701215637235805,5176,5536,119.0,,9.0,,253,731,857,172998,6171
2021-01-25,S92000003,Scotland,1318,174316,3189.096231247713,159.14745700695207,52,6223,113.84924990852544,4929,1182170,21627.69849981705,26507,1599,6.032368808239333,7.2707191531039665,15050,11457,148.0,,14.0,,502,1097,1318,174316,6223
2021-01-26,S92000003,Scotland,1178,175494,3210.647639956092,152.37833882180755,50,6273,114.76399560922064,4150,1186320,21703.62239297476,27252,1418,5.203287832085719,7.120547886994766,15829,11423,160.0,,6.0,,403,1015,1178,175494,6273
2021-01-27,S92000003,Scotland,1112,176606,3230.9915843395534,143.96267837541163,61,6334,115.8799853640688,4305,1190625,21782.38199780461,22619,1314,5.809275387948185,6.827794561933535,12422,10197,157.0,,13.0,,344,970,1112,176606,6334
2021-01-28,S92000003,Scotland,1113,177719,3251.3538236370287,141.63922429564582,46,6380,116.72155140870838,4500,1195125,21864.709110867178,21071,1310,6.217075601537658,6.634565480652787,10328,10743,140.0,,8.0,,400,910,1113,177719,6380
2021-01-29,S92000003,Scotland,961,178680,3268.935236004391,136.7544822539334,59,6439,117.80095133552872,3985,1199110,21937.614343212583,17483,1159,6.629297031401933,6.478567473846781,9237,8246,152.0,,12.0,,324,835,961,178680,6439
2021-01-30,S92000003,Scotland,779,179459,3283.186974021222,133.88218075375045,44,6483,118.60592755214051,2826,1201936,21989.31577021588,10537,931,8.835531935085887,6.39957115897225,4880,5657,117.0,,9.0,,221,710,779,179459,6483
2021-01-31,S92000003,Scotland,809,180268,3297.9875594584705,133.00402488108307,48,6531,119.4840834248079,2456,1204392,22034.248079034027,9806,966,9.851111564348358,6.429125854740343,5019,4787,108.0,,12.0,,240,726,809,180268,6531
2021-02-01,S92000003,Scotland,1095,181363,3318.020490303696,128.92425905598245,43,6574,120.27076472740578,4194,1208586,22110.97694840834,24555,1302,5.302382406841784,6.300488287842308,15672,8883,123.0,,9.0,,325,977,1095,181363,6574
2021-02-02,S92000003,Scotland,1049,182412,3337.211855104281,126.5642151481888,44,6618,121.07574094401755,4031,1212617,22184.72374679839,27108,1246,4.5964290984211305,6.178151210025605,17207,9901,112.0,,11.0,,348,898,1049,182412,6618
2021-02-03,S92000003,Scotland,930,183342,3354.226125137212,123.23454079765824,48,6666,121.95389681668496,3695,1216312,22252.323454079768,21780,1107,5.082644628099174,6.06090373280943,13180,8600,111.0,,5.0,,281,826,930,183342,6666
2021-02-04,S92000003,Scotland,899,184241,3370.673252835712,119.31942919868276,32,6698,122.5393340651299,3822,1220134,22322.24661544091,20882,1073,5.138396705296428,5.89023162896989,11210,9672,111.0,,7.0,,273,800,899,184241,6698
2021-02-05,S92000003,Scotland,935,185176,3387.778997438712,118.84376143432128,44,6742,123.34431028174168,3660,1223794,22389.2060007318,17944,1081,6.024297815425769,5.810937170090188,9918,8026,114.0,,14.0,,291,790,935,185176,6742
2021-02-06,S92000003,Scotland,698,185874,3400.548847420417,117.36187339919503,51,6793,124.27735089645078,2522,1226316,22435.345773874866,9856,805,8.167613636363637,5.74542753408979,4878,4978,92.0,,7.0,,154,651,698,185874,6793
2021-02-07,S92000003,Scotland,654,186528,3412.5137211855103,114.52616172703988,42,6835,125.04573728503476,2271,1228587,22476.89352360044,9200,780,8.478260869565217,5.630306491528651,4908,4292,96.0,,10.0,,208,572,654,186528,6835
2021-02-08,S92000003,Scotland,991,187519,3430.643980973289,112.62349066959383,40,6875,125.77753384559092,3655,1232242,22543.76143432126,23519,1155,4.910923083464433,5.562250074833639,15665,7854,83.0,,15.0,,315,840,991,187519,6875
2021-02-09,S92000003,Scotland,758,188277,3444.5115257958287,107.29967069154776,49,6924,126.67398463227222,2815,1235057,22595.2616172704,21985,888,4.039117580168297,5.503890832973811,15756,6229,97.0,,9.0,,300,588,758,188277,6924
2021-02-10,S92000003,Scotland,845,189122,3459.9707281375777,105.7446030003659,37,6961,127.35089645078668,2837,1237894,22647.164288327844,18369,1006,5.476618215471719,5.575130384789126,11929,6440,80.0,,7.0,,326,680,845,189122,6961
2021-02-11,S92000003,Scotland,842,189964,3475.375045737285,104.70179290157336,35,6996,127.99121844127332,3449,1241343,22710.2634467618,20219,1015,5.020030664226717,5.557757737918277,11116,9103,95.0,,12.0,,331,684,842,189964,6996
2021-02-12,S92000003,Scotland,902,190866,3491.8770581778267,104.09806073911452,41,7037,128.7413099158434,3643,1244986,22776.91181851445,17615,1027,5.830258302583026,5.528183301176685,9403,8212,94.0,,12.0,,283,744,902,190866,7037
2021-02-13,S92000003,Scotland,542,191408,3501.7929015733625,101.24405415294548,32,7069,129.32674716428832,2534,1247520,22823.27113062569,9783,641,6.552182357150159,5.395641726737924,4785,4998,70.0,,7.0,,154,487,542,191408,7069
2021-02-14,S92000003,Scotland,681,192089,3514.251738016831,101.73801683132088,32,7101,129.91218441273327,2245,1249765,22864.3432125869,9258,775,8.371138474832577,5.388909133070527,4927,4331,63.0,,9.0,,173,602,681,192089,7101
2021-02-15,S92000003,Scotland,963,193052,3531.8697402122207,101.22575923893156,34,7135,130.534211489206,3783,1253548,22933.552872301498,24548,1102,4.489164086687306,5.299851367663845,16652,7896,90.0,,13.0,,273,829,963,193052,7135
2021-02-16,S92000003,Scotland,912,193964,3548.554701792902,104.0431759970728,26,7161,131.0098792535675,3703,1257251,23001.298938894983,25697,1055,4.105537611394326,5.276159663396792,18127,7570,98.0,,8.0,,231,824,912,193964,7161
2021-02-17,S92000003,Scotland,825,194789,3563.6480058543725,103.67727771679472,28,7189,131.52213684595682,3459,1260710,23064.58104646908,20833,978,4.694475111601785,5.152673247207959,13726,7107,74.0,,8.0,,216,762,825,194789,7189
2021-02-18,S92000003,Scotland,879,195668,3579.729235272594,104.3541895353092,35,7224,132.16245883644345,4163,1264873,23140.74277350897,23216,1012,4.359062715368712,5.032455135547919,12021,11195,77.0,,9.0,,217,795,879,195668,7224
2021-02-19,S92000003,Scotland,890,196558,3596.0117087449685,104.13465056714234,44,7268,132.96743505305523,4237,1269110,23218.25832418588,19494,1027,5.268287678259977,4.961265988601887,9536,9958,91.0,,12.0,,188,839,890,196558,7268
2021-02-20,S92000003,Scotland,660,197218,3608.0863519941454,106.29345042078302,27,7295,133.46139773143065,3014,1272124,23273.399195023783,11480,766,6.672473867595818,4.991600136776534,5085,6395,85.0,,3.0,,136,630,660,197218,7295
2021-02-21,S92000003,Scotland,609,197827,3619.2279546286136,104.97621661178192,20,7315,133.82729601170877,2517,1274641,23319.447493596777,9866,705,7.145753091425096,4.917341305666968,4677,5189,70.0,,10.0,,142,563,609,197827,7315
2021-02-22,S92000003,Scotland,787,198614,3633.626051957556,101.7563117453348,22,7337,134.22978412001464,4451,1279092,23400.878155872662,24945,946,3.79234315494087,4.787834517564248,16795,8150,72.0,,9.0,,204,742,787,198614,7337
2021-02-23,S92000003,Scotland,693,199307,3646.304427369192,97.7497255762898,16,7353,134.5225027442371,3825,1282917,23470.85620197585,25696,809,3.1483499377335,4.6063602154504535,18380,7316,66.0,,6.0,,172,637,693,199307,7353
2021-02-24,S92000003,Scotland,699,200006,3659.0925722649104,95.44456641053787,18,7371,134.85181119648738,3520,1286437,23535.2542993048,21100,796,3.772511848341232,4.463279748448051,14005,7095,57.0,,5.0,,142,654,699,200006,7371
2021-02-25,S92000003,Scotland,628,200634,3670.581778265642,90.85254299304792,20,7391,135.21770947676546,3813,1290250,23605.01280643981,22163,719,3.244145648152326,4.2807100872766135,11056,11107,49.0,,3.0,,122,597,628,200634,7391
2021-02-26,S92000003,Scotland,514,201148,3679.985364068789,83.97365532381998,16,7407,135.51042810098792,3544,1293794,23669.849981705083,17832,604,3.38716913414087,4.016320764641349,8935,8897,62.0,,6.0,,112,492,514,201148,7407
2021-02-27,S92000003,Scotland,414,201562,3687.5594584705455,79.47310647639956,19,7426,135.8580314672521,2594,1296388,23717.30698865716,10199,503,4.931856064320032,3.8558129300991646,4528,5671,50.0,,4.0,,94,409,414,201562,7426
2021-02-28,S92000003,Scotland,426,201988,3695.353091840469,76.1251372118551,9,7435,136.02268569337724,2256,1298644,23758.58031467252,9387,489,5.209332054969639,3.705395897107872,4733,4654,53.0,,3.0,,68,421,426,201988,7435
2021-03-01,S92000003,Scotland,547,202535,3705.3604098060737,71.73435784851812,20,7455,136.38858397365533,4081,1302725,23833.241858763264,23843,663,2.780690349368788,3.5194286591921364,16526,7317,66.0,,7.0,,156,507,547,202535,7455
2021-03-02,S92000003,Scotland,518,203053,3714.837175265277,68.53274789608489,12,7467,136.60812294182216,3681,1306406,23900.585437248446,25455,610,2.396385778825378,3.372852537717632,18970,6485,63.0,,4.0,,114,496,518,203053,7467
2021-03-03,S92000003,Scotland,495,203548,3723.893157702159,64.80058543724844,11,7478,136.80936699597513,3318,1309724,23961.28796194658,20016,596,2.97761790567546,3.246052988866907,13868,6148,40.0,,9.0,,116,480,495,203548,7478
2021-03-04,S92000003,Scotland,558,204106,3734.1017197219176,63.51994145627516,14,7492,137.06549579216977,3485,1313209,24025.045737285032,22368,657,2.9372317596566524,3.192873741285825,11256,11112,45.0,,0.0,,106,551,558,204106,7492
2021-03-05,S92000003,Scotland,465,204571,3742.608854738383,62.62349066959385,8,7500,137.21185510428103,3661,1316870,24092.02341748993,18562,547,2.946880724059908,3.13101748440268,8799,9763,38.0,,3.0,,101,446,465,204571,7500
2021-03-06,S92000003,Scotland,480,205051,3751.390413465057,63.83095499451153,10,7510,137.39480424442004,2633,1319503,24140.193926088545,11024,558,5.061683599419449,3.1533427729516665,4639,6385,36.0,,5.0,,76,482,480,205051,7510
2021-03-07,S92000003,Scotland,433,205484,3759.312111233077,63.95901939260885,10,7520,137.5777533845591,2533,1322036,24186.53494328577,10460,497,4.7514340344168255,3.13373011053079,4999,5461,23.0,,4.0,,74,423,433,205484,7520
2021-03-08,S92000003,Scotland,588,206072,3770.069520673253,64.70911086717892,15,7535,137.85217709476763,4565,1326601,24270.05122575924,25490,672,2.6363279717536288,3.101780693533271,17067,8423,34.0,,2.0,,123,549,588,206072,7535
2021-03-09,S92000003,Scotland,653,206725,3782.016099524332,67.17892425905599,10,7545,138.0351262349067,4177,1330778,24346.46908159532,26183,741,2.8300805866401864,3.1826282782637225,18479,7704,45.0,,4.0,,103,638,653,206725,7545
2021-03-10,S92000003,Scotland,622,207347,3793.395536040981,69.5023783388218,5,7550,138.12660080497622,3904,1334682,24417.8924259056,21627,698,3.227447172515837,3.22000677896164,13936,7691,34.0,,2.0,,97,601,622,207347,7550
2021-03-11,S92000003,Scotland,662,208009,3805.506769118185,71.40504939626784,8,7558,138.27296011708745,3765,1338447,24486.77277716795,24113,740,3.068884004478912,3.23951141795008,11811,12302,34.0,,3.0,,115,625,662,208009,7558
2021-03-12,S92000003,Scotland,584,208593,3816.190998902305,73.58214416392244,6,7564,138.3827296011709,4037,1342484,24560.62934504208,21088,654,3.101289833080425,3.257491874129371,9271,11817,40.0,,2.0,,80,574,584,208593,7564
2021-03-13,S92000003,Scotland,464,209057,3824.679839004757,73.28942553969996,4,7568,138.4559092572265,2694,1345178,24609.91584339553,11672,538,4.609321453050034,3.2282607922749285,4774,6898,28.0,,4.0,,75,463,464,209057,7568
2021-03-14,S92000003,Scotland,443,209500,3832.784485912917,73.472374679839,7,7575,138.5839736553238,2508,1347686,24655.79948774241,10259,504,4.912759528219125,3.237866013444229,4662,5597,26.0,,4.0,,64,440,443,209500,7575
2021-03-15,S92000003,Scotland,688,210188,3845.371386754482,75.30186608122942,1,7576,138.60226856933772,4609,1352295,24740.12074643249,26180,756,2.8877005347593583,3.2815578010515725,17338,8842,40.0,,4.0,,106,650,688,210188,7576
2021-03-16,S92000003,Scotland,572,210760,3855.836077570436,73.81997804610319,11,7587,138.8035126234907,4246,1356541,24817.80095133553,27225,637,2.3397612488521577,3.184350468473031,19666,7559,25.0,,2.0,,88,549,572,210760,7587
2021-03-17,S92000003,Scotland,597,211357,3866.758141236736,73.36260519575558,8,7595,138.94987193560192,3749,1360290,24886.388583973658,21705,683,3.146740382400368,3.172058885561227,14299,7406,36.0,,5.0,,93,590,597,211357,7595
2021-03-18,S92000003,Scotland,552,211909,3876.856933772412,71.35016465422612,3,7598,139.0047566776436,3783,1364073,24955.59824368825,24030,618,2.571785268414482,3.088091503176021,11759,12271,32.0,,0.0,,76,542,552,211909,7598
2021-03-19,S92000003,Scotland,542,212451,3886.7727771679474,70.58177826564216,6,7604,139.11452616172704,4268,1368341,25033.6809366996,21978,603,2.743652743652744,3.0332263769757213,9713,12265,23.0,,2.0,,71,532,542,212451,7604
2021-03-20,S92000003,Scotland,458,212909,3895.151847786316,70.47200878155873,5,7609,139.20600073179656,2844,1371185,25085.711672155143,12041,512,4.25213852670044,3.007293366244125,4754,7287,19.0,,3.0,,44,468,458,212909,7609
2021-03-21,S92000003,Scotland,463,213372,3903.622392974753,70.83790706183682,4,7613,139.27918038785216,2574,1373759,25132.80278082693,10987,500,4.55083280240284,2.989330262372872,4966,6021,29.0,,2.0,,65,435,463,213372,7613
2021-03-22,S92000003,Scotland,680,214052,3916.062934504208,70.69154774972557,3,7616,139.3340651298939,5392,1379151,25231.4489571899,28230,753,2.667375132837407,2.9453610221893896,17205,11025,32.0,,1.0,,85,668,680,214052,7616
2021-03-23,S92000003,Scotland,603,214655,3927.094767654592,71.2586900841566,3,7619,139.3889498719356,5265,1384416,25327.771679473102,29221,671,2.2962937613360253,2.92863312459512,19195,10026,28.0,,4.0,,61,610,603,214655,7619
2021-03-24,S92000003,Scotland,541,215196,3936.992316136114,70.23417489937798,4,7623,139.46212952799124,4447,1388863,25409.129162092937,23533,599,2.545361832320571,2.836955072656979,14363,9170,27.0,,3.0,,65,534,541,215196,7623
2021-03-25,S92000003,Scotland,573,215769,3947.475301866081,70.61836809366996,7,7630,139.59019392608857,4242,1393105,25486.73618733992,25768,645,2.50310462589258,2.8222564873021523,11914,13854,29.0,,4.0,,61,584,573,215769,7630
2021-03-26,S92000003,Scotland,474,216243,3956.147091108672,69.37431394072448,5,7635,139.68166849615807,4057,1397162,25560.95865349433,22276,525,2.3567965523433294,2.765428526332404,9884,12392,24.0,,3.0,,58,467,474,216243,7635
2021-03-27,S92000003,Scotland,386,216629,3963.208927918039,68.05708013172338,5,7640,139.7731430662276,2871,1400033,25613.483351628245,12223,424,3.468870162807821,2.704318238547537,4921,7302,20.0,,2.0,,31,393,386,216629,7640
2021-03-28,S92000003,Scotland,357,216986,3969.740212221003,66.11781924624954,5,7645,139.8646176362971,3000,1403033,25668.36809366996,12554,406,3.234028994742712,2.615649686291083,5819,6735,24.0,,4.0,,37,369,357,216986,7645
2021-03-29,S92000003,Scotland,514,217500,3979.143798024149,63.08086351994146,5,7650,139.95609220636663,5529,1408562,25769.52067325284,29314,569,1.941052057037593,2.478549154555844,18608,10706,22.0,,2.0,,58,511,514,217500,7650
2021-03-30,S92000003,Scotland,394,217894,3986.351994145628,59.25722649103549,2,7652,139.99268203439445,4659,1413221,25854.75667764361,26991,449,1.6635174687858916,2.3693329577686217,18305,8686,20.0,,2.0,,56,393,394,217894,7652
2021-03-31,S92000003,Scotland,394,218288,3993.5601902671056,56.567874130991584,1,7653,140.01097694840834,3904,1417125,25926.1800219539,22337,462,2.068317141961767,2.297590830763949,14545,7792,21.0,,2.0,,58,404,394,218288,7653
2021-04-01,S92000003,Scotland,413,218701,4001.1159897548487,53.64068788876693,1,7654,140.02927186242223,3470,1420595,25989.663373582145,23868,463,1.939835763365175,2.205090831288487,11925,11943,22.0,,3.0,,52,411,413,218701,7654
2021-04-02,S92000003,Scotland,353,219054,4007.5740944017566,51.427003293084525,2,7656,140.06586169045005,2861,1423456,26042.005122575923,16670,397,2.3815236952609475,2.2020464444243766,7173,9497,26.0,,1.0,,41,356,353,219054,7656
2021-04-03,S92000003,Scotland,280,219334,4012.6966703256494,49.48774240761068,2,7658,140.10245151847786,2463,1425919,26087.06549579217,11323,319,2.817274573876181,2.142502638808307,5195,6128,17.0,,1.0,,36,283,280,219334,7658
2021-04-04,S92000003,Scotland,254,219588,4017.343578485181,47.60336626417856,1,7659,140.1207464324918,2255,1428174,26128.320526893523,11354,294,2.589395807644882,2.0816737982616296,6596,4758,15.0,,0.0,,33,261,254,219588,7659
2021-04-05,S92000003,Scotland,293,219881,4022.703988291255,43.56019026710575,4,7663,140.1939260885474,3055,1431229,26184.211489206,20356,335,1.645706425623895,2.045914566701029,14487,5869,31.0,,2.0,,39,296,293,219881,7663
2021-04-06,S92000003,Scotland,356,220237,4029.2169776802048,42.86498353457738,2,7665,140.2305159165752,4052,1435281,26258.342480790343,25299,392,1.5494683584331397,2.028855167788304,17677,7622,19.0,,2.0,,37,355,356,220237,7665
2021-04-07,S92000003,Scotland,282,220519,4034.376143432126,40.815953165020126,2,7667,140.267105744603,3291,1438572,26318.5510428101,22214,325,1.4630413252903576,1.9262457660736625,15663,6551,21.0,,2.0,,35,290,282,220519,7667
2021-04-08,S92000003,Scotland,282,220801,4039.535309184047,38.41931942919868,2,7669,140.3036955726308,3012,1441584,26373.655323819978,23011,337,1.4645169701447134,1.84216790680888,12076,10935,21.0,,0.0,,40,297,282,220801,7669
2021-04-09,S92000003,Scotland,266,221067,4044.4017563117454,36.82766190998903,2,7671,140.34028540065862,3088,1444672,26430.15001829492,19469,302,1.5511839334326365,1.731992242118082,9568,9901,20.0,,0.0,,47,255,266,221067,7671
2021-04-10,S92000003,Scotland,227,221294,4048.5547017929016,35.858031467252104,3,7674,140.39517014270032,2294,1446966,26472.11855104281,10273,265,2.579577533339823,1.7048554282596835,4877,5396,15.0,,1.0,,42,223,227,221294,7674
2021-04-11,S92000003,Scotland,212,221506,4052.433223563849,35.089645078668134,2,7676,140.43175997072814,2196,1449162,26512.294182217345,10044,244,2.429311031461569,1.6836820596023447,5433,4611,13.0,,1.0,,27,217,212,221506,7676
2021-04-12,S92000003,Scotland,260,221766,4057.189901207464,34.485912916209294,0,7676,140.43175997072814,3660,1452822,26579.25356750824,23934,307,1.2826940753739449,1.617949405560025,17724,6210,14.0,,1.0,,35,272,260,221766,7676
2021-04-13,S92000003,Scotland,261,222027,4061.9648737650937,32.7478960848884,0,7676,140.43175997072814,3354,1456176,26640.614709110865,23988,298,1.2422878105719526,1.563193488449068,18737,5251,11.0,,2.0,,46,252,261,222027,7676
2021-04-14,S92000003,Scotland,212,222239,4065.843395536041,31.46725210391511,3,7679,140.48664471276985,2840,1459016,26692.57226491035,19990,244,1.2206103051525763,1.5278213435953147,14811,5179,15.0,,2.0,,26,218,212,222239,7679
2021-04-15,S92000003,Scotland,198,222437,4069.465788510794,29.930479326747164,2,7681,140.52323454079766,2738,1461754,26742.663739480427,20883,241,1.15404874778528,1.4784454935021505,11738,9145,15.0,,0.0,,39,202,198,222437,7681
2021-04-16,S92000003,Scotland,382,222819,4076.454445664105,32.05268935236005,1,7682,140.54152945481155,2571,1464325,26789.69996341017,18006,633,3.515494835054981,1.7558488963010743,9111,8895,14.0,,1.0,,30,603,382,222819,7682
2021-04-17,S92000003,Scotland,202,223021,4080.150018294914,31.59531650201244,1,7683,140.55982436882545,1888,1466213,26824.240761068424,9551,228,2.3871845880012565,1.7366055887844554,4604,4947,10.0,,2.0,,27,201,202,223021,7683
2021-04-18,S92000003,Scotland,178,223199,4083.406512989389,30.9732894255397,0,7683,140.55982436882545,2022,1468235,26861.23307720454,10190,215,2.1099116781158,1.711684658058194,5960,4230,12.0,,0.0,,24,191,178,223199,7683
2021-04-19,S92000003,Scotland,264,223463,4088.23637028906,31.046469081595315,1,7684,140.57811928283937,3551,1471786,26926.19831686791,24469,301,1.2301279169561483,1.6997568403408956,18435,6034,14.0,,2.0,,39,262,264,223463,7684
2021-04-20,S92000003,Scotland,242,223705,4092.6637394804247,30.69886571533113,1,7685,140.5964141968533,3363,1475149,26987.72411269667,24253,261,1.0761555271512802,1.6671640150146847,19079,5174,13.0,,0.0,,35,226,242,223705,7685
2021-04-21,S92000003,Scotland,237,223942,4096.99963410172,31.15623856567874,3,7688,140.651298938895,2857,1478006,27039.9926820344,19331,265,1.3708551032021106,1.6924133467000306,14137,5194,13.0,,1.0,,38,227,237,223942,7688
2021-04-22,S92000003,Scotland,231,224173,4101.225759238932,31.75997072813757,0,7688,140.651298938895,2775,1480781,27090.76106842298,21069,271,1.2862499406711283,1.7135785731739035,11559,9510,11.0,,1.0,,38,233,231,224173,7688
2021-04-23,S92000003,Scotland,188,224361,4104.665203073546,28.210757409440177,2,7690,140.68788876692278,2856,1483637,27143.01134284669,18238,214,1.1733742734949009,1.3807916538815588,9523,8715,12.0,,1.0,,27,187,188,224361,7690
2021-04-24,S92000003,Scotland,150,224511,4107.409440175631,27.259421880717163,0,7690,140.68788876692278,2065,1485702,27180.7903402854,9773,173,1.7701831576793206,1.3351868868939627,4894,4879,9.0,,2.0,,23,150,150,224511,7690
2021-04-25,S92000003,Scotland,109,224620,4109.403585803147,25.99707281375777,2,7692,140.7244785949506,1982,1487684,27217.05085986096,10108,127,1.2564305500593589,1.266887245463333,6252,3856,9.0,,0.0,,14,113,109,224620,7692
2021-04-26,S92000003,Scotland,195,224815,4112.971094035858,24.734723746798387,2,7694,140.7610684229784,3775,1491459,27286.11416026345,25421,217,0.85362495574525,1.191952758730976,19270,6151,12.0,,1.0,,26,191,195,224815,7694
2021-04-27,S92000003,Scotland,195,225010,4116.538602268569,23.87486278814489,1,7695,140.77936333699233,3676,1495135,27353.36626417856,24308,226,0.929735066644726,1.1641507080032438,18654,5654,12.0,,2.0,,34,192,195,225010,7695
2021-04-28,S92000003,Scotland,193,225203,4120.069520673253,23.069886571533115,1,7696,140.79765825100625,2837,1497972,27405.268935236003,19692,217,1.101970343286614,1.1235605595253833,14499,5193,7.0,,0.0,,43,174,193,225203,7696
2021-04-29,S92000003,Scotland,174,225377,4123.252835711673,22.02707647274058,0,7696,140.79765825100625,2638,1500610,27453.53091840469,20734,199,0.9597762129835054,1.070364999922042,11605,9129,9.0,,0.0,,24,175,174,225377,7696
2021-04-30,S92000003,Scotland,172,225549,4126.399560922064,21.734357848518112,0,7696,140.79765825100625,2717,1503327,27503.238199780462,17120,197,1.1507009345794392,1.0664066186416683,8364,8756,9.0,,3.0,,24,173,172,225549,7696
2021-05-01,S92000003,Scotland,126,225675,4128.704720087815,21.29527991218441,0,7696,140.79765825100625,2105,1505432,27541.74899377973,9463,145,1.5322836309838317,1.0469388076880626,4648,4815,8.0,,1.0,,10,135,126,225675,7696
2021-05-02,S92000003,Scotland,121,225796,4130.918404683498,21.51481888035126,1,7697,140.81595316502012,1959,1507391,27577.58873033297,9908,135,1.3625353249899073,1.0549089588301248,6078,3830,7.0,,1.0,,14,121,121,225796,7697
2021-05-03,S92000003,Scotland,162,225958,4133.882180753751,20.911086717892427,0,7697,140.81595316502012,3181,1510572,27635.7848518112,21235,174,0.8194019307746645,1.0558549730524254,16342,4893,6.0,,2.0,,15,159,162,225958,7697
2021-05-04,S92000003,Scotland,196,226154,4137.467983900476,20.92938163190633,0,7697,140.81595316502012,3959,1514531,27708.21441639224,26391,213,0.8070933272706604,1.0277574813518222,19730,6661,11.0,,2.0,,19,194,196,226154,7697
2021-05-05,S92000003,Scotland,222,226376,4141.529454811562,21.45993413830955,0,7697,140.81595316502012,3172,1517703,27766.245883644347,20649,245,1.18649813550293,1.0422310756972113,14668,5981,8.0,,0.0,,33,212,222,226376,7697
2021-05-06,S92000003,Scotland,218,226594,4145.517746066593,22.26491035492133,0,7697,140.81595316502012,2845,1520548,27818.294914013903,21320,242,1.1350844277673546,1.0714908871722475,11806,9514,18.0,,2.0,,25,217,218,226594,7697
2021-05-07,S92000003,Scotland,203,226797,4149.231613611416,22.832052689352363,0,7697,140.81595316502012,3125,1523673,27875.46652030736,18877,226,1.1972241351909731,1.0794490116783868,9758,9119,12.0,,1.0,,19,207,203,226797,7697
2021-05-08,S92000003,Scotland,185,226982,4152.616172703989,23.911452616172703,0,7697,140.81595316502012,2412,1526085,27919.593852908893,10196,200,1.9615535504119264,1.1160714285714286,4919,5277,11.0,,1.0,,19,181,185,226982,7697
2021-05-09,S92000003,Scotland,210,227192,4156.458104646908,25.53969996341017,0,7697,140.81595316502012,2393,1528478,27963.37358214416,11022,226,2.050444565414625,1.176652016346673,6194,4828,12.0,,0.0,,18,208,210,227192,7697
2021-05-10,S92000003,Scotland,329,227521,4162.477131357482,28.59495060373216,0,7697,140.81595316502012,4501,1532979,28045.718990120746,26438,361,1.365458809289659,1.269895398575167,18620,7818,7.0,,3.0,,27,334,329,227521,7697
2021-05-11,S92000003,Scotland,283,227804,4167.6545920234175,30.186608122941823,0,7697,140.81595316502012,4149,1537128,28121.62458836444,26398,316,1.197060383362376,1.346182357301705,19663,6735,18.0,,1.0,,27,289,283,227804,7697
2021-05-12,S92000003,Scotland,298,228102,4173.106476399561,31.577021587998537,2,7699,140.85254299304793,3588,1540716,28187.266739846324,21132,322,1.5237554419837214,1.3982553200918877,14401,6731,11.0,,0.0,,31,291,298,228102,7699
2021-05-13,S92000003,Scotland,314,228416,4178.851079399927,33.333333333333336,0,7699,140.85254299304793,3171,1543887,28245.27991218441,21996,332,1.5093653391525732,1.4574559566070602,11778,10218,14.0,,0.0,,48,284,314,228416,7699
2021-05-14,S92000003,Scotland,291,228707,4184.174899377973,34.9432857665569,0,7699,140.85254299304793,3675,1547562,28312.51372118551,19968,314,1.5725160256410255,1.5100255195041925,9647,10321,9.0,,0.0,,14,300,291,228707,7699
2021-05-15,S92000003,Scotland,228,228935,4188.346139773143,35.729967069154775,0,7699,140.85254299304793,2939,1550501,28366.282473472376,11338,247,2.178514729229141,1.531541954704538,4944,6394,6.0,,0.0,,18,229,228,228935,7699
2021-05-16,S92000003,Scotland,231,229166,4192.5722649103545,36.11416026344676,0,7699,140.85254299304793,2649,1553150,28414.745700695203,12141,246,2.026192241166296,1.5335949100142745,6584,5557,11.0,,1.0,,21,225,231,229166,7699
2021-05-17,S92000003,Scotland,361,229527,4199.176728869375,36.699597511891696,1,7700,140.87083790706183,5493,1558643,28515.23966337358,29171,401,1.3746529087107058,1.5322489869428186,19121,10050,11.0,,1.0,,24,377,361,229527,7700
2021-05-18,S92000003,Scotland,417,229944,4206.805708013173,39.15111598975485,0,7700,140.87083790706183,4754,1563397,28602.213684595685,28079,448,1.595498415185726,1.6061185468451242,19639,8440,20.0,,0.0,,47,401,417,229944,7700
2021-05-19,S92000003,Scotland,409,230353,4214.288327844859,41.18185144529821,0,7700,140.87083790706183,4463,1567860,28683.86388583974,23257,447,1.9220019778991275,1.668379582048647,14727,8530,19.0,,1.0,,31,416,409,230353,7700
2021-05-20,S92000003,Scotland,381,230734,4221.258690084156,42.40761068422978,0,7700,140.87083790706183,4320,1572180,28762.8979143798,25122,417,1.659899689515166,1.690412943733398,11922,13200,21.0,,1.0,,42,375,381,230734,7700
2021-05-21,S92000003,Scotland,360,231094,4227.844859129163,43.669959751189175,0,7700,140.87083790706183,4539,1576719,28845.938529088915,22097,400,1.810200479703128,1.7234879798948448,9736,12361,25.0,,3.0,,22,378,360,231094,7700
2021-05-22,S92000003,Scotland,291,231385,4233.168679107208,44.82253933406513,1,7701,140.88913282107575,3208,1579927,28904.62861324552,12203,319,2.6141112841104643,1.7610311040967976,4997,7206,21.0,,1.0,,29,290,291,231385,7701
2021-05-23,S92000003,Scotland,324,231709,4239.096231247713,46.52396633735821,1,7702,140.90742773508964,2893,1582820,28957.555799487745,12899,359,2.783161485386464,1.8262360300468496,6590,6309,16.0,,0.0,,25,334,324,231709,7702
2021-05-24,S92000003,Scotland,496,232205,4248.17050859861,48.99377972923528,0,7702,140.90742773508964,5505,1588325,29058.26930113429,29159,531,1.821050104598923,1.911449062925348,18519,10640,21.0,,1.0,,34,497,496,232205,7702
2021-05-25,S92000003,Scotland,504,232709,4257.391145261618,50.58543724844493,0,7702,140.90742773508964,5236,1593561,29154.061470911085,29658,564,1.901679142221323,1.967032611159688,19953,9705,21.0,,1.0,,46,518,504,232709,7702
2021-05-26,S92000003,Scotland,627,233336,4268.862056348336,54.57372850347603,1,7703,140.92572264910353,4576,1598137,29237.778997438712,24416,665,2.7236238532110093,2.0925209252092523,14812,9604,14.0,,1.0,,29,636,627,233336,7703
2021-05-27,S92000003,Scotland,552,233888,4278.96084888401,57.70215879985364,1,7704,140.94401756311746,4285,1602422,29316.17270398829,24876,588,2.363724071394115,2.205939166044248,11738,13138,18.0,,1.0,,33,555,552,233888,7704
2021-05-28,S92000003,Scotland,549,234437,4289.004756677644,61.15989754848152,1,7705,140.96231247713135,4181,1606603,29392.663739480424,21313,593,2.782339417257073,2.3420310113639307,9309,12004,29.0,,1.0,,30,563,549,234437,7705
2021-05-29,S92000003,Scotland,435,234872,4296.963044273692,63.79436516648372,2,7707,140.99890230515916,3142,1609745,29450.14635931211,12378,464,3.7485862013249314,2.433112043387481,4933,7445,26.0,,1.0,,27,437,435,234872,7707
2021-05-30,S92000003,Scotland,486,235358,4305.854372484449,66.7581412367362,1,7708,141.01719721917308,2998,1612743,29504.994511525794,12839,526,4.096892281330321,2.542049547656154,6362,6477,21.0,,1.0,,21,505,486,235358,7708
2021-05-31,S92000003,Scotland,601,235959,4316.849615806806,68.67910720819613,0,7708,141.01719721917308,4603,1617346,29589.2060007318,26443,676,2.556442158605302,2.6829380673104137,17715,8728,23.0,,0.0,,35,641,601,235959,7708
2021-06-01,S92000003,Scotland,773,236732,4330.991584339554,73.60043907793633,0,7708,141.01719721917308,6066,1623412,29700.18294914014,31092,867,2.7884986491702044,2.855428835984011,19287,11805,31.0,,4.0,,46,821,773,236732,7708
2021-06-02,S92000003,Scotland,959,237691,4348.536406878888,79.67435053055252,1,7709,141.03549213318698,5622,1629034,29803.036955726307,26574,1017,3.827048995258523,3.042150274893097,14594,11980,22.0,,2.0,,44,973,959,237691,7709
2021-06-03,S92000003,Scotland,949,238640,4365.898280278083,86.93743139407245,2,7711,141.07208196121476,5456,1634490,29902.85400658617,28337,1024,3.613649998235523,3.250176127214171,12195,16142,33.0,,0.0,,65,959,949,238640,7711
2021-06-04,S92000003,Scotland,822,239462,4380.936699597512,91.93194291986828,1,7712,141.09037687522869,5880,1640370,30010.428100987923,26176,889,3.3962408312958434,3.334370937322616,10330,15846,21.0,,1.0,,42,847,822,239462,7712
2021-06-05,S92000003,Scotland,606,240068,4392.023417489938,95.06037321624588,0,7712,141.09037687522869,3946,1644316,30082.619831686792,14138,652,4.6116848210496535,3.4124602201704115,5030,9108,20.0,,2.0,,23,629,606,240068,7712
2021-06-06,S92000003,Scotland,677,240745,4404.409074277352,98.55470179290155,1,7713,141.10867178924258,3790,1648106,30151.957555799487,14982,726,4.845814977973569,3.488094812271226,6843,8139,29.0,,2.0,,35,691,677,240745,7713
2021-06-07,S92000003,Scotland,953,241698,4421.844127332602,104.99451152579584,1,7714,141.1269667032565,6728,1654834,30275.045737285032,31989,1021,3.191722154490606,3.575550528599788,18239,13750,29.0,,4.0,,44,977,953,241698,7714
2021-06-08,S92000003,Scotland,1026,242724,4440.614709110867,109.62312477131358,0,7714,141.1269667032565,6405,1661239,30392.224661544093,32778,1104,3.368112758557569,3.67654622972556,20062,12716,23.0,,1.0,,48,1056,1026,242724,7714
2021-06-09,S92000003,Scotland,1056,243780,4459.93413830955,111.39773143066228,2,7716,141.1635565312843,5804,1667043,30498.4083424808,27481,1118,4.068265346966996,3.715011854606239,14719,12762,31.0,,0.0,,49,1069,1056,243780,7716
2021-06-10,S92000003,Scotland,1040,244820,4478.96084888401,113.06256860592757,2,7718,141.2001463593121,5328,1672371,30595.88364434687,27490,1136,4.132411786104038,3.796976587405875,11828,15662,32.0,,2.0,,46,1090,1040,244820,7718
2021-06-11,S92000003,Scotland,865,245685,4494.7859495060375,113.84924990852544,0,7718,141.2001463593121,5360,1677731,30693.9443834614,24667,959,3.8877853001986455,3.870335686500504,10003,14664,25.0,,3.0,,43,916,865,245685,7718
2021-06-12,S92000003,Scotland,706,246391,4507.702158799853,115.67874130991584,0,7718,141.2001463593121,3856,1681587,30764.48957189901,14337,765,5.335844318895166,3.9309479404112273,5058,9279,33.0,,1.0,,36,729,706,246391,7718
2021-06-13,S92000003,Scotland,855,247246,4523.344310281742,118.93523600439076,3,7721,141.25503110135384,3708,1685295,30832.32711306257,14971,919,6.138534500033398,4.042299655178369,6343,8628,24.0,,2.0,,36,883,855,247246,7721
2021-06-14,S92000003,Scotland,1129,248375,4543.999268203439,122.1551408708379,1,7722,141.27332601536773,7432,1692727,30968.294914013903,34762,1219,3.506702721362407,4.090976054757885,19246,15516,40.0,,1.0,,63,1156,1129,248375,7722
2021-06-15,S92000003,Scotland,1279,249654,4567.398463227223,126.78375411635568,6,7728,141.38309549945114,6981,1699708,31096.01170874497,34481,1366,3.9616020417041273,4.198912390776086,19543,14938,33.0,,2.0,,68,1298,1279,249654,7728
2021-06-16,S92000003,Scotland,1265,250919,4590.541529454811,130.6073911452616,1,7729,141.40139041346507,6751,1706459,31219.52067325284,30129,1352,4.487370971489263,4.266825926110254,15024,15105,40.0,,0.0,,73,1279,1265,250919,7729
2021-06-17,S92000003,Scotland,1164,252083,4611.836809366996,132.87596048298573,1,7730,141.41968532747896,6293,1712752,31334.650567142337,30097,1249,4.1499152739475695,4.267787444669763,12347,17750,24.0,,1.0,,64,1185,1164,252083,7730
2021-06-18,S92000003,Scotland,1231,253314,4634.357848518112,139.57189901207465,3,7733,141.47457006952067,5687,1718439,31438.693743139407,25676,1323,5.152671755725191,4.441781917344797,9942,15734,47.0,,4.0,,76,1247,1231,253314,7733
2021-06-19,S92000003,Scotland,997,254311,4652.597877789975,144.89571899012074,2,7735,141.51115989754848,4420,1722859,31519.557263080867,15914,1082,6.799044866155586,4.5745309896253294,5061,10853,27.0,,1.0,,39,1043,997,254311,7735
2021-06-20,S92000003,Scotland,1548,255859,4680.918404683498,157.5740944017563,3,7738,141.5660446395902,4787,1727646,31607.13501646542,18716,1647,8.799957255823895,4.867869845870109,6628,12088,30.0,,1.0,,50,1597,1548,255859,7738
2021-06-21,S92000003,Scotland,3019,258878,4736.150750091474,192.1514818880352,2,7740,141.602634467618,9016,1736662,31772.081961214782,41143,3163,7.687820528400943,5.700564856542751,19107,22036,35.0,,5.0,,93,3070,3019,258878,7740
2021-06-22,S92000003,Scotland,3243,262121,4795.481156238566,228.08269301134283,4,7744,141.67581412367363,9052,1745714,31937.68752286864,41981,3405,8.110812034015389,6.49182935931178,20105,21876,46.0,,0.0,,109,3296,3243,262121,7744
2021-06-23,S92000003,Scotland,2891,265012,4848.371752652763,257.83022319795094,1,7745,141.69410903768753,8835,1754549,32099.323088181485,36500,3074,8.42191780821918,7.114799525775258,14842,21658,55.0,,1.0,,119,2955,2891,265012,7745
2021-06-24,S92000003,Scotland,2947,267959,4902.286864251738,290.4500548847421,2,7747,141.7306988657153,8510,1763059,32255.01280643981,37891,3098,8.176084030508564,7.709082228068001,12669,25222,50.0,,1.0,,123,2975,2947,267959,7747
2021-06-25,S92000003,Scotland,2619,270578,4950.201244054153,315.843395536041,1,7748,141.74899377972923,7257,1770316,32387.77899743871,31780,2809,8.838892385147892,8.16255442670537,10511,21269,42.0,,2.0,,90,2719,2619,270578,7748
2021-06-26,S92000003,Scotland,2292,272870,4992.133186974021,339.5353091840468,8,7756,141.89535309184046,5218,1775534,32483.241858763264,20060,2441,12.168494516450648,8.610038102169938,5382,14678,30.0,,0.0,,89,2352,2292,272870,7756
2021-06-27,S92000003,Scotland,2511,275381,5038.071716062934,357.1533113794365,3,7759,141.9502378338822,4989,1780523,32574.51518477863,20614,2628,12.748617444455224,8.96555622714366,6590,14024,36.0,,3.0,,76,2552,2511,275381,7759
2021-06-28,S92000003,Scotland,3922,279303,5109.824368825466,373.673618733992,3,7762,142.00512257592388,9196,1789719,32742.755214050496,43063,4145,9.625432505863502,9.314801478293496,19601,23462,59.0,,2.0,,161,3984,3922,279303,7762
2021-06-29,S92000003,Scotland,3873,283176,5180.680570801317,385.1994145627516,3,7765,142.0600073179656,8295,1798014,32894.511525795824,40799,4098,10.044363832446871,9.66290576358758,19456,21343,69.0,,0.0,,149,3949,3873,283176,7765
2021-06-30,S92000003,Scotland,3907,287083,5252.158799853641,403.7870472008782,1,7766,142.0783022319795,8238,1806252,33045.22502744237,37024,4160,11.235955056179774,10.110668552226992,15079,21945,68.0,,3.0,,159,4001,3907,287083,7766
2021-07-01,S92000003,Scotland,3429,290512,5314.892060007318,412.60519575558,2,7768,142.11489206000732,7630,1813882,33184.81522136846,36768,3672,9.986945169712794,10.40945990578337,13055,23713,62.0,,6.0,,150,3522,3429,290512,7768
2021-07-02,S92000003,Scotland,3078,293590,5371.203805342115,421.002561287962,2,7770,142.15148188803514,6873,1820755,33310.55616538602,31788,3333,10.485088712721785,10.636809261415982,10161,21627,66.0,,3.0,,167,3166,3078,293590,7770
2021-07-03,S92000003,Scotland,2509,296099,5417.105744603001,424.97255762897913,4,7774,142.22466154409074,5310,1826065,33407.70215879985,21238,2714,12.778981071663996,10.700666683960671,5570,15668,55.0,,5.0,,106,2608,2509,296099,7774
2021-07-04,S92000003,Scotland,2407,298506,5461.141602634468,423.06988657153306,6,7780,142.33443102817418,4734,1830799,33494.31028174167,21093,2576,12.2125823732992,10.656116113611162,7565,13528,68.0,,4.0,,129,2447,2407,298506,7780
2021-07-05,S92000003,Scotland,3378,301884,5522.941822173436,413.1174533479692,5,7785,142.4259055982437,8164,1838963,33643.66995975119,40314,3687,9.145706206280696,10.584043593684504,19216,21098,83.0,,9.0,,186,3501,3378,301884,7785
2021-07-06,S92000003,Scotland,3091,304975,5579.491401390414,398.8108305890962,13,7798,142.66373948042445,7596,1846559,33782.6381266008,38691,3378,8.730712568814452,10.36506901232174,19752,18939,101.0,,2.0,,205,3173,3091,304975,7798
2021-07-07,S92000003,Scotland,2896,307871,5632.47347237468,380.3146725210392,5,7803,142.75521405049398,6381,1852940,33899.377972923525,31992,3221,10.068142035508878,10.17693930161706,14829,17163,89.0,,8.0,,193,3028,2896,307871,7803
2021-07-08,S92000003,Scotland,2729,310600,5682.400292718624,367.5082327113062,12,7815,142.9747530186608,5849,1858789,34006.38492499085,32429,3017,9.30340127663511,10.078834264175228,12798,19631,102.0,,7.0,,186,2831,2729,310600,7815
2021-07-09,S92000003,Scotland,2382,312982,5725.978777899743,354.774972557629,7,7822,143.10281741675814,5638,1864427,34109.53165020124,27581,2678,9.709582683731554,9.970563143931226,10179,17402,83.0,,5.0,,173,2505,2382,312982,7822
2021-07-10,S92000003,Scotland,1812,314794,5759.129162092938,342.0234174899378,8,7830,143.24917672886937,4055,1868482,34183.717526527624,17126,2017,11.777414457549924,9.83338590806114,5153,11973,84.0,,5.0,,116,1901,1812,314794,7830
2021-07-11,S92000003,Scotland,1881,316675,5793.541895353092,332.4002927186242,6,7836,143.35894621295282,3823,1872305,34253.65898280278,18203,2068,11.360764709113882,9.724914702233251,7378,10825,73.0,,5.0,,138,1930,1881,316675,7836
2021-07-12,S92000003,Scotland,2577,319252,5840.687888766923,317.746066593487,7,7843,143.48701061105012,6711,1879016,34376.43615075009,35273,2883,8.173390411929804,9.56904046300206,18334,16939,102.0,,7.0,,197,2686,2577,319252,7843
2021-07-13,S92000003,Scotland,2443,321695,5885.382363702891,305.89096231247714,9,7852,143.65166483717528,6092,1885108,34487.8887669228,34528,2710,7.848702502316961,9.43225858815413,19074,15454,104.0,,7.0,,256,2454,2443,321695,7852
2021-07-14,S92000003,Scotland,2204,323899,5925.704354189536,293.2308818148555,8,7860,143.7980241492865,5283,1890391,34584.54079765825,28490,2487,8.72937872937873,9.22377730723545,14400,14090,79.0,,4.0,,184,2303,2204,323899,7860
2021-07-15,S92000003,Scotland,1963,325862,5961.6172703988295,279.21697768020493,7,7867,143.92608854738384,4854,1895245,34673.34431028174,28044,2221,7.919697618028812,9.016882876694233,12320,15724,78.0,,7.0,,190,2031,1963,325862,7867
2021-07-16,S92000003,Scotland,1749,327611,5993.615075009147,267.6362971094036,5,7872,144.01756311745336,4616,1899861,34757.79363336992,24094,1955,8.114053291275836,8.79692933817117,9551,14543,68.0,,8.0,,135,1820,1749,327611,7872
2021-07-17,S92000003,Scotland,1400,329011,6019.227954628614,260.0987925356751,7,7879,144.14562751555067,3382,1903243,34819.66703256495,14527,1578,10.862531837268534,8.682074044955476,4785,9742,49.0,,6.0,,101,1477,1400,329011,7879
2021-07-18,S92000003,Scotland,1385,330396,6044.56641053787,251.02451518477864,8,7887,144.29198682766193,3319,1906562,34880.3878521771,16413,1547,9.425455431670017,8.480501077912985,6969,9444,67.0,,6.0,,107,1440,1385,330396,7887
2021-07-19,S92000003,Scotland,1908,332304,6079.4731064764,238.7852177094768,9,7896,144.45664105378705,6063,1912625,34991.30991584339,32921,2147,6.521673096199994,8.180787299530213,18461,14460,77.0,,5.0,,175,1972,1908,332304,7896
2021-07-20,S92000003,Scotland,1598,333902,6108.708379070618,223.3260153677278,6,7902,144.5664105378705,5463,1918088,35091.255031101355,30836,1799,5.834090024646517,7.833452160273777,18698,12138,66.0,,9.0,,160,1639,1598,333902,7902
2021-07-21,S92000003,Scotland,1573,335475,6137.48627881449,211.78192462495429,8,7910,144.7127698499817,4887,1922975,35180.662275887305,25516,1739,6.8153315566703245,7.534624110100899,13784,11732,74.0,,6.0,,140,1599,1573,335475,7910
2021-07-22,S92000003,Scotland,1378,336853,6162.696670325649,201.0793999268204,9,7919,144.87742407610685,4444,1927419,35261.96487376509,25587,1551,6.061671942783445,7.249225987968969,11447,14140,58.0,,10.0,,130,1421,1378,336853,7919
2021-07-23,S92000003,Scotland,1277,338130,6186.059275521405,192.4442005122576,7,7926,145.00548847420416,4165,1931584,35338.16319063301,22131,1437,6.493154398807103,7.025504522690867,9387,12744,62.0,,6.0,,115,1322,1277,338130,7926
2021-07-24,S92000003,Scotland,954,339084,6203.512623490669,184.28466886205635,3,7929,145.0603732162459,3251,1934835,35397.63995609221,13585,1064,7.832167832167832,6.757331321224751,4846,8739,43.0,,7.0,,81,983,954,339084,7929
2021-07-25,S92000003,Scotland,942,340026,6220.746432491767,176.1800219538968,5,7934,145.1518477863154,3150,1937985,35455.268935236,14678,1035,7.051369396375529,6.51845038546722,6958,7720,52.0,,6.0,,98,937,942,340026,7934
2021-07-26,S92000003,Scotland,1372,341398,6245.847054518844,166.3739480424442,7,7941,145.27991218441272,6108,1944093,35567.01427003293,31792,1551,4.878585807750378,6.2001523229246,18390,13402,53.0,,4.0,,128,1423,1372,341398,7941
2021-07-27,S92000003,Scotland,1353,342751,6270.600073179657,161.89169410903767,8,7949,145.42627149652395,5132,1949225,35660.90376875229,29538,1503,5.088360755636807,6.06778974003083,18218,11320,59.0,,5.0,,145,1358,1353,342751,7949
2021-07-28,S92000003,Scotland,1286,344037,6294.127332601537,156.64105378704718,9,7958,145.5909257226491,4317,1953542,35739.88291255031,23773,1418,5.964749926387078,5.934170991532368,13209,10564,67.0,,3.0,,121,1297,1286,344037,7958
2021-07-29,S92000003,Scotland,1171,345208,6315.550676911818,152.85400658616905,6,7964,145.70069520673252,4129,1957671,35815.42261251372,24704,1299,5.258257772020725,5.809576719246447,11153,13551,43.0,,3.0,,101,1198,1171,345208,7964
2021-07-30,S92000003,Scotland,1034,346242,6334.467618002196,148.40834248079034,7,7971,145.82875960482986,3919,1961590,35887.12038053421,21569,1141,5.289999536371645,5.644610652785347,9590,11979,51.0,,3.0,,99,1042,1034,346242,7971
2021-07-31,S92000003,Scotland,769,347011,6348.536406878888,145.02378338821808,6,7977,145.93852908891327,3324,1964914,35947.93267471642,13234,874,6.604201299682636,5.537768067902165,4912,8322,34.0,,5.0,,64,810,769,347011,7977
2021-08-01,S92000003,Scotland,873,347884,6364.507866813025,143.7614343212587,10,7987,146.12147822905234,3301,1968215,36008.32418587633,14685,957,6.51685393258427,5.488558962930412,6828,7857,38.0,,3.0,,95,862,873,347884,7987
2021-08-02,S92000003,Scotland,1322,349206,6388.693743139408,142.8466886205635,7,7994,146.24954262714965,5378,1973593,36106.71423344311,29531,1454,4.923639565202668,5.505814027535438,17368,12163,49.0,,5.0,,145,1309,1322,349206,7994
2021-08-03,S92000003,Scotland,1366,350572,6413.684595682401,143.08452250274425,3,7997,146.30442736919136,4966,1978559,36197.56677643615,29368,1481,5.042903840915282,5.497756017951856,18167,11201,50.0,,3.0,,112,1369,1366,350572,7997
2021-08-04,S92000003,Scotland,1292,351864,6437.321624588364,143.19429198682766,6,8003,146.4141968532748,4520,1983079,36280.259787779,24312,1413,5.811944718657453,5.475753321092991,13451,10861,38.0,,4.0,,91,1322,1292,351864,8003
2021-08-05,S92000003,Scotland,1331,353195,6461.672155140871,146.12147822905234,7,8010,146.5422612513721,4615,1987694,36364.69081595317,25969,1459,5.61823712888444,5.532936698010941,11807,14162,69.0,,3.0,,75,1384,1331,353195,8010
2021-08-06,S92000003,Scotland,1256,354451,6484.650567142335,150.18294914013904,7,8017,146.67032564946945,4422,1992116,36445.590925722645,21925,1385,6.316989737742304,5.673986316530838,9071,12854,54.0,,1.0,,105,1280,1256,354451,8017
2021-08-07,S92000003,Scotland,941,355392,6501.866081229418,153.32967435053055,6,8023,146.7800951335529,3460,1995576,36508.89132821076,13939,1021,7.324772221823659,5.740973774330272,4900,9039,41.0,,4.0,,63,958,941,355392,8023
2021-08-08,S92000003,Scotland,1040,356432,6520.892791803878,156.38492499085254,6,8029,146.8898646176363,3297,1998873,36569.209659714594,15540,1131,7.277992277992277,5.818761520450357,6946,8594,40.0,,3.0,,96,1035,1040,356432,8029
2021-08-09,S92000003,Scotland,1488,357920,6548.115623856568,159.42188071716063,6,8035,146.99963410171972,6543,2005416,36688.91328210757,33153,1617,4.877386661840558,5.789678818069985,17941,15212,37.0,,3.0,,114,1503,1488,357920,8035
2021-08-10,S92000003,Scotland,1518,359438,6575.887303329675,162.20270764727405,5,8040,147.09110867178924,5519,2010935,36789.88291255031,30494,1666,5.463369843247852,5.862144049548787,18167,12327,70.0,,5.0,,141,1525,1518,359438,8040
2021-08-11,S92000003,Scotland,1567,361005,6604.555433589462,167.23380900109768,3,8043,147.14599341383095,5197,2016132,36884.96158068057,25655,1701,6.6302864938608455,5.987700614969252,13289,12366,41.0,,2.0,,127,1574,1567,361005,8043
2021-08-12,S92000003,Scotland,1391,362396,6630.003658982802,168.33150384193195,4,8047,147.21917306988655,4830,2020962,36973.32601536773,26305,1537,5.842995628207565,6.022357808767087,11521,14784,39.0,,3.0,,110,1427,1391,362396,8047
2021-08-13,S92000003,Scotland,1523,363919,6657.866813025978,173.21624588364435,10,8057,147.40212221002562,5177,2026139,37068.03878521771,23818,1670,7.011503904609959,6.1235968360725614,9425,14393,40.0,,3.0,,110,1560,1523,363919,8057
2021-08-14,S92000003,Scotland,1471,365390,6684.778631540432,182.91255031101355,6,8063,147.51189169410904,3875,2030014,37138.93157702159,15665,1573,10.04149377593361,6.38516087440661,5160,10505,45.0,,2.0,,73,1500,1471,365390,8063
2021-08-15,S92000003,Scotland,1628,367018,6714.562751555067,193.6699597511892,6,8069,147.62166117819245,4291,2034305,37217.435053055255,18369,1734,9.439817083129183,6.628655763033339,7156,11213,31.0,,5.0,,93,1641,1628,367018,8069
2021-08-16,S92000003,Scotland,2746,369764,6764.800585437249,216.6849615806805,3,8072,147.6765459202342,7905,2042210,37362.056348335165,37463,2898,7.735632490724181,7.1885424342826925,18042,19421,34.0,,5.0,,151,2747,2746,369764,8072
2021-08-17,S92000003,Scotland,3362,373126,6826.308086351994,250.4207830223198,4,8076,147.7497255762898,7864,2050074,37505.92755214051,38854,3561,9.165079528491276,7.883779529251218,18397,20457,58.0,,1.0,,185,3376,3362,373126,8076
2021-08-18,S92000003,Scotland,3704,376830,6894.072447859495,289.5170142700329,7,8083,147.8777899743871,7697,2057771,37646.74350530552,35702,3964,11.103019438686909,8.633573933610636,14298,21404,62.0,,1.0,,207,3757,3704,376830,8083
2021-08-19,S92000003,Scotland,3711,380541,6961.964873765093,331.96121478229054,7,8090,148.00585437248444,8113,2065884,37795.17014270033,37963,3938,10.373258172431052,9.304541124166402,12142,25821,59.0,,2.0,,182,3756,3711,380541,8090
2021-08-20,S92000003,Scotland,3422,383963,7024.570069520673,366.7032564946945,7,8097,148.13391877058177,7805,2073689,37937.96194657885,34134,3665,10.7370949786137,9.779051111620443,10503,23631,66.0,,1.0,,182,3483,3422,383963,8097
2021-08-21,S92000003,Scotland,3030,386993,7080.003658982803,395.225027442371,5,8102,148.2253933406513,6183,2079872,38051.07939992682,23382,3230,13.814044991874091,10.178556407089127,5527,17855,48.0,,5.0,,125,3105,3030,386993,8102
2021-08-22,S92000003,Scotland,3645,390638,7146.688620563484,432.1258690084156,4,8106,148.29857299670692,6820,2086692,38175.85071350165,27718,3817,13.770834836568294,10.65956397523978,7490,20228,54.0,,6.0,,123,3694,3645,390638,8106
2021-08-23,S92000003,Scotland,5518,396156,7247.639956092207,482.839370654958,7,8113,148.42663739480423,12011,2098703,38395.59092572265,51980,5763,11.08695652173913,11.187147873929357,19011,32969,76.0,,7.0,,248,5515,5518,396156,8113
2021-08-24,S92000003,Scotland,5597,401753,7350.036589828028,523.7285034760337,4,8117,148.49981705085986,11046,2109749,38597.67654592024,49734,5899,11.861101057626572,11.617225541319888,19376,30358,101.0,,5.0,,313,5586,5597,401753,8117
2021-08-25,S92000003,Scotland,6823,408576,7474.862788144896,580.7903402854007,5,8122,148.59129162092938,11689,2121438,38811.52579582876,49771,7205,14.47630146068996,12.202110076379231,14707,35064,107.0,,7.0,,295,6910,6823,408576,8122
2021-08-26,S92000003,Scotland,7223,415799,7607.006952067326,645.042078302232,5,8127,148.6827661909989,12627,2134065,39042.53567508233,54747,7613,13.905784791860745,12.760321958650408,13102,41645,102.0,,9.0,,315,7298,7223,415799,8127
2021-08-27,S92000003,Scotland,6020,421819,7717.142334431028,692.5722649103549,10,8137,148.86571533113795,11794,2145859,39258.30589096232,47743,6397,13.398822864084789,13.086618044743096,10813,36930,106.0,,8.0,,262,6135,6020,421819,8137
2021-08-28,S92000003,Scotland,4736,426555,7803.787047200879,723.7833882180754,8,8145,149.01207464324918,8922,2154781,39421.533113794365,32833,5032,15.326043919227605,13.266311847033313,5744,27089,102.0,,4.0,,225,4807,4736,426555,8145
2021-08-29,S92000003,Scotland,4431,430986,7884.851811196488,738.163190633004,8,8153,149.1584339553604,8135,2162916,39570.36223929747,33053,4821,14.585665446404258,13.358927784256286,7961,25092,92.0,,7.0,,220,4601,4431,430986,8153
2021-08-30,S92000003,Scotland,6519,437505,8004.116355653127,756.476399560922,6,8159,149.26820343944385,14489,2177405,39835.43724844493,63769,6954,10.904985180887266,13.2431780491482,20964,42805,113.0,,6.0,,324,6630,6519,437505,8159
2021-08-31,S92000003,Scotland,6957,444462,8131.394072447859,781.3574826198317,10,8169,149.45115257958287,16235,2193640,40132.455177460666,65813,7371,11.199914910428031,13.054131234380796,19686,46127,131.0,,8.0,,329,7042,6957,444462,8169
2021-09-01,S92000003,Scotland,7491,451953,8268.441273326016,793.5784851811196,8,8177,149.5975118916941,15514,2209154,40416.282473472376,61326,7923,12.919479502984052,12.834136783157613,15481,45845,155.0,,8.0,,368,7555,7491,451953,8177
2021-09-02,S92000003,Scotland,7526,459479,8406.128796194658,799.1218441273327,11,8188,149.79875594584706,14669,2223823,40684.65056714234,61353,8023,13.076785161279808,12.714477028615155,13807,47546,131.0,,8.0,,374,7649,7526,459479,8188
2021-09-03,S92000003,Scotland,6130,465609,8518.27661909989,801.1342846688622,11,8199,150.0,12654,2236477,40916.15440907428,50366,6588,13.080252551324309,12.67580790908326,10963,39403,153.0,,7.0,,298,6290,6130,465609,8199
2021-09-04,S92000003,Scotland,4986,470595,8609.495060373216,805.7080131723382,10,8209,150.18294914013904,9891,2246368,41097.10940358581,35491,5357,15.093967484714437,12.672595649983432,5955,29536,123.0,,7.0,,221,5136,4986,470595,8209
2021-09-05,S92000003,Scotland,4900,475495,8699.140139041347,814.288327844859,17,8226,150.4939626783754,9797,2256165,41276.34467618002,37386,5263,14.077462151607554,12.644073032510972,7828,29558,113.0,,16.0,,211,5052,4900,475495,8226
2021-09-06,S92000003,Scotland,7086,482581,8828.77789974387,824.6615440907427,10,8236,150.67691181851444,17990,2274155,41605.47017929016,70042,7546,10.773535878472916,12.591381879998009,20157,49885,157.0,,13.0,,435,7111,7086,482581,8236
2021-09-07,S92000003,Scotland,6657,489238,8950.567142334432,819.1730698865715,18,8254,151.00622027076471,16569,2290724,41908.59860958654,66685,7093,10.63657494189098,12.490036560921366,20279,46406,201.0,,12.0,,450,6643,6657,489238,8254
2021-09-08,S92000003,Scotland,6208,495446,9064.141968532747,795.7006952067325,10,8264,151.18916941090376,15260,2305984,42187.77899743871,59071,6650,11.257639112254743,12.229425280104312,15616,43455,167.0,,10.0,,397,6253,6208,495446,8264
2021-09-09,S92000003,Scotland,5516,500962,9165.056714233442,758.9279180387853,17,8281,151.50018294914014,13952,2319936,42443.0296377607,55558,5950,10.709528780733647,11.865221209880431,13280,42278,165.0,,9.0,,323,5627,5516,500962,8281
2021-09-10,S92000003,Scotland,4756,505718,9252.067325283571,733.790706183681,25,8306,151.95755579948775,11773,2331709,42658.4156604464,46008,5133,11.156755346896192,11.611896035285126,10824,35184,169.0,,10.0,,315,4818,4756,505718,8306
2021-09-11,S92000003,Scotland,3616,509334,9318.221734357849,708.7266739846323,21,8327,152.34174899377973,8971,2340680,42822.53933406513,30431,3902,12.822450790312509,11.374359564161333,5650,24781,132.0,,13.0,,254,3648,3616,509334,8327
2021-09-12,S92000003,Scotland,3353,512687,9379.564581046468,680.4244420051226,22,8349,152.7442371020856,8929,2349609,42985.89462129528,32131,3603,11.213469857769756,11.079221840044898,7848,24283,137.0,,12.0,,215,3388,3353,512687,8349
2021-09-13,S92000003,Scotland,5053,517740,9472.008781558729,643.2308818148555,21,8370,153.1284302963776,15669,2365278,43272.55762897914,62663,5490,8.7611509184048,10.727931311286154,20475,42188,175.0,,9.0,,373,5117,5053,517740,8370
2021-09-14,S92000003,Scotland,4745,522485,9558.8181485547,608.2510062202707,20,8390,153.49432857665568,14062,2379340,43529.820709842665,58227,5110,8.775997389527197,10.415328592311871,19807,38420,158.0,,7.0,,368,4742,4745,522485,8390
2021-09-15,S92000003,Scotland,4050,526535,9632.912550311014,568.7705817782656,23,8413,153.91511159897547,11709,2391049,43744.03585803146,47333,4370,9.232459383516783,10.09715631967408,14310,33023,170.0,,11.0,,303,4067,4050,526535,8413
2021-09-16,S92000003,Scotland,3555,530090,9697.950969630445,532.8942553969996,16,8429,154.20783022319796,10503,2401552,43936.1873399195,43733,3888,8.890311663960853,9.826347940572685,12410,31323,155.0,,9.0,,294,3594,3555,530090,8429
2021-09-17,S92000003,Scotland,3354,533444,9759.312111233075,507.244785949506,24,8453,154.64690815953165,9303,2410855,44106.38492499085,37785,3676,9.72872833134842,9.618543529841212,10421,27364,140.0,,15.0,,270,3406,3354,533444,8453
2021-09-18,S92000003,Scotland,2604,536048,9806.952067325285,488.730332967435,21,8474,155.03110135382366,7151,2418006,44237.21185510428,25088,2838,11.31218112244898,9.439340630701068,5434,19654,114.0,,13.0,,198,2640,2604,536048,8474
2021-09-19,S92000003,Scotland,2781,538829,9857.83022319795,478.2656421514819,28,8502,155.54335894621295,7238,2425244,44369.63044273692,27779,3011,10.839123078584542,9.379461217152224,7490,20289,102.0,,6.0,,201,2810,2781,538829,8502
2021-09-20,S92000003,Scotland,3991,542820,9930.845225027442,458.8364434687157,20,8522,155.90925722649104,12619,2437863,44600.49396267838,53267,4284,8.042502862935777,9.268720243373394,18871,34396,150.0,,7.0,,383,3901,3991,542820,8522
2021-09-21,S92000003,Scotland,3780,546600,10000.0,441.1818514452983,21,8543,156.29345042078302,11442,2449305,44809.824368825466,50942,4056,7.961995995445801,9.13624806331686,19364,31578,117.0,,8.0,,345,3711,3780,546600,8543
2021-09-22,S92000003,Scotland,3488,550088,10063.812660080495,430.90010976948406,31,8574,156.86059275521407,10009,2459314,44992.93816319063,43381,3771,8.692745672068417,9.05186630020392,14965,28416,107.0,,10.0,,340,3431,3488,550088,8574
2021-09-23,S92000003,Scotland,3096,553184,10120.453713867544,422.5027442371021,19,8593,157.20819612147824,8912,2468226,45155.98243688255,40332,3374,8.365565803828225,8.977865845340915,12025,28307,130.0,,4.0,,249,3125,3096,553184,8593
2021-09-24,S92000003,Scotland,2698,555882,10169.813391877058,410.501280643981,22,8615,157.6106842297841,7706,2475932,45296.96304427369,32323,2913,9.012158524889395,8.878042707753595,9380,22943,107.0,,9.0,,241,2672,2698,555882,8615
2021-09-25,S92000003,Scotland,2125,558007,10208.690084156604,401.7380168313209,21,8636,157.9948774240761,5976,2481908,45406.29345042078,21885,2271,10.376970527758738,8.773327306610748,5208,16677,86.0,,7.0,,143,2128,2125,558007,8636
2021-09-26,S92000003,Scotland,2135,560142,10247.74972557629,389.9195023783389,20,8656,158.36077570435418,5637,2487545,45509.42188071717,23564,2284,9.69275165506705,8.638885334256702,7338,16226,82.0,,2.0,,178,2106,2135,560142,8656
2021-09-27,S92000003,Scotland,3112,563254,10304.68349798756,373.8382729601171,24,8680,158.7998536406879,9573,2497118,45684.55909257226,44776,3339,7.457119885653028,8.556665357713557,18041,26735,117.0,,9.0,,307,3032,3112,563254,8680
2021-09-28,S92000003,Scotland,3175,566429,10362.769849981703,362.7698499817051,16,8696,159.09257226491036,9850,2506968,45864.76399560922,46481,3422,7.362147974441169,8.456845320524488,19152,27329,116.0,,5.0,,327,3095,3175,566429,8696
2021-09-29,S92000003,Scotland,2585,569014,10410.062202707648,346.24954262714965,25,8721,159.54994511525794,8175,2515143,46014.324917672886,38297,2831,7.392223933989607,8.250894378538145,14825,23472,102.0,,5.0,,251,2580,2585,569014,8721
2021-09-30,S92000003,Scotland,2360,571374,10453.23819978046,332.78448591291624,16,8737,159.84266373948043,7324,2522467,46148.31686791072,35773,2551,7.131076510217203,8.067083780681944,12411,23362,88.0,,6.0,,241,2310,2360,571374,8737
2021-10-01,S92000003,Scotland,2040,573414,10490.559824368826,320.7464324917673,19,8756,160.1902671057446,6559,2529026,46268.31320892792,29625,2210,7.4599156118143455,7.865191908519516,9655,19970,101.0,,6.0,,187,2023,2040,573414,8756
2021-10-02,S92000003,Scotland,1860,575274,10524.588364434689,315.89828027808267,23,8779,160.6110501280644,5200,2534226,46363.446761800216,20170,1983,9.831432821021318,7.80104404950437,5568,14602,88.0,,8.0,,157,1826,1860,575274,8779
2021-10-03,S92000003,Scotland,1979,577253,10560.793999268204,313.04427369191365,15,8794,160.88547383827296,5014,2539240,46455.17746066594,22451,2094,9.326978753730346,7.757615553956048,7495,14956,86.0,,7.0,,150,1944,1979,577253,8794
2021-10-04,S92000003,Scotland,2945,580198,10614.67252103915,309.98902305159163,14,8808,161.14160263446763,10019,2549259,46638.474204171245,46072,3144,6.824101406494183,7.633891379793946,18995,27077,132.0,,7.0,,262,2882,2945,580198,8808
2021-10-05,S92000003,Scotland,2831,583029,10666.465422612517,303.6955726308086,23,8831,161.56238565678743,8579,2557838,46795.42627149653,41944,3017,7.192923898531375,7.60886263933223,18354,23590,107.0,,6.0,,276,2741,2831,583029,8831
2021-10-06,S92000003,Scotland,2637,585666,10714.70911086718,304.6469081595316,13,8844,161.80021953896818,7388,2565226,46930.58909623125,35653,2857,8.013350910161837,7.706916197645109,14265,21388,86.0,,7.0,,259,2598,2637,585666,8844
2021-10-07,S92000003,Scotland,2594,588260,10762.166117819246,308.9279180387852,19,8863,162.14782290523237,6978,2572204,47058.25100622027,34483,2779,8.059043586694893,7.849026467243639,12202,22281,118.0,,4.0,,251,2528,2594,588260,8863
2021-10-08,S92000003,Scotland,2279,590539,10803.860226856934,313.30040248810826,14,8877,162.403951701427,6343,2578547,47174.29564581047,28910,2462,8.51608439986164,7.983176813260015,9667,19243,108.0,,9.0,,222,2240,2279,590539,8877
2021-10-09,S92000003,Scotland,2129,592668,10842.810098792535,318.2217343578485,17,8894,162.71496523966337,4819,2583366,47262.45883644347,19132,2258,11.802216182312357,8.139692536464825,5218,13914,93.0,,9.0,,177,2081,2129,592668,8894
2021-10-10,S92000003,Scotland,1879,594547,10877.18624222466,316.3922429564581,14,8908,162.97109403585802,4659,2588025,47347.69484083425,20432,1992,9.749412685982772,8.167200585987485,7099,13333,73.0,,5.0,,158,1834,1879,594547,8908
2021-10-11,S92000003,Scotland,2813,597360,10928.649835345774,313.9773143066228,22,8930,163.37358214416392,8147,2596172,47496.74350530553,40202,3004,7.47226506143973,8.32095163891355,18014,22188,89.0,,3.0,,254,2750,2813,597360,8930
2021-10-12,S92000003,Scotland,2620,599980,10976.582510062202,310.117087449689,16,8946,163.6663007683864,7471,2603643,47633.4248079034,37691,2782,7.38107240455281,8.375865461448571,17677,20014,98.0,,3.0,,241,2541,2620,599980,8946
2021-10-13,S92000003,Scotland,2630,602610,11024.69813391877,309.98902305159163,19,8965,164.01390413465057,6425,2610068,47750.969630442734,32318,2779,8.598923200693113,8.470314493732642,13803,18515,82.0,,3.0,,203,2576,2630,602610,8965
2021-10-14,S92000003,Scotland,2673,605283,11073.600439077936,311.4343212586901,20,8985,164.37980241492863,5688,2615756,47855.03110135382,30927,2870,9.279917224431726,8.657424193271378,11608,19319,116.0,,9.0,,269,2601,2673,605283,8985
2021-10-15,S92000003,Scotland,2568,607851,11120.581778265643,316.7215514087084,16,9001,164.67252103915112,5630,2621386,47958.031467252105,27327,2705,9.89863504958466,8.840113638002393,9649,17678,121.0,,8.0,,219,2486,2568,607851,9001
2021-10-16,S92000003,Scotland,2149,610000,11159.897548481522,317.08744968898645,18,9019,165.0018294914014,4849,2626235,48046.74350530552,19410,2258,11.633178773827924,8.82831589912965,5136,14274,81.0,,3.0,,148,2110,2149,610000,9019
2021-10-17,S92000003,Scotland,2299,612299,11201.957555799489,324.7713135748262,15,9034,165.27625320160996,4942,2631177,48137.15697036224,22167,2435,10.98479722109442,8.966301977699697,7026,15141,67.0,,4.0,,150,2285,2299,612299,9034
2021-10-18,S92000003,Scotland,2950,615249,11255.927552140503,327.2777167947311,15,9049,165.5506769118185,9091,2640268,48303.47603366264,43461,3127,7.194956397689883,8.886971931683396,18227,25234,118.0,,7.0,,257,2870,2950,615249,9049
2021-10-19,S92000003,Scotland,2764,618013,11306.494694474935,329.91218441273327,9,9058,165.71533113794365,8799,2649067,48464.45298207098,42040,2948,7.012369172216937,8.78566505858029,17746,24294,127.0,,10.0,,273,2675,2764,618013,9058
2021-10-20,S92000003,Scotland,2840,620853,11358.452250274424,333.75411635565314,16,9074,166.0080497621661,8320,2657387,48616.66666666667,37431,3066,8.191071571691912,8.712847286129206,13959,23472,118.0,,9.0,,309,2757,2840,620853,9074
2021-10-21,S92000003,Scotland,2536,623389,11404.848152213684,331.24771313574826,22,9096,166.410537870472,7802,2665189,48759.40358580315,35931,2720,7.570064846511369,8.455570824570724,11524,24407,98.0,,8.0,,231,2489,2536,623389,9096
2021-10-22,S92000003,Scotland,2444,625833,11449.560922063663,328.9791437980241,16,9112,166.70325649469447,7821,2673010,48902.48810830589,32425,2614,8.061680801850423,8.231378695810877,9932,22493,106.0,,11.0,,184,2430,2444,625833,9112
2021-10-23,S92000003,Scotland,2132,627965,11488.56567874131,328.6681302597878,23,9135,167.12403951701427,6300,2679310,49017.746066593485,22734,2295,10.09501187648456,8.131200013548472,5275,17459,79.0,,5.0,,185,2110,2132,627965,9135
2021-10-24,S92000003,Scotland,2319,630284,11530.991584339554,329.03402854006583,21,9156,167.50823271130625,6713,2686023,49140.55982436882,26397,2478,9.387430389817023,8.006022818496042,7441,18956,73.0,,3.0,,176,2302,2319,630284,9156
2021-10-25,S92000003,Scotland,3296,633580,11591.291620929382,335.3640687888767,8,9164,167.65459202341748,10904,2696927,49340.04756677643,48643,3553,7.304236991961845,8.010553702957235,18377,30266,120.0,,9.0,,333,3220,3296,633580,9164
2021-10-26,S92000003,Scotland,2916,636496,11644.639590193929,338.1448957189901,19,9183,168.00219538968167,10178,2707105,49526.25320160996,46007,3148,6.84243702045341,7.963360687267598,18956,27051,112.0,,8.0,,305,2843,2916,636496,9183
2021-10-27,S92000003,Scotland,2651,639147,11693.139407244786,334.68715697036225,14,9197,168.25832418587635,8283,2715388,49677.78997438712,37394,2888,7.723164143980318,7.893207657565593,14666,22728,110.0,,9.0,,292,2596,2651,639147,9197
2021-10-28,S92000003,Scotland,2497,641644,11738.821807537504,333.97365532382,20,9217,168.6242224661544,7143,2722531,49808.47054518844,34221,2705,7.904503082902312,7.941619152533481,11871,22350,109.0,,11.0,,246,2459,2497,641644,9217
2021-10-29,S92000003,Scotland,2547,644191,11785.418953530918,335.8580314672521,19,9236,168.97182583241857,7660,2730191,49948.60958653494,31747,2726,8.58663810753772,8.008723694379368,10343,21404,103.0,,9.0,,290,2436,2547,644191,9236
2021-10-30,S92000003,Scotland,2029,646220,11822.53933406513,333.97365532382,16,9252,169.26454445664106,6373,2736564,50065.20307354555,21957,2177,9.914833538279364,7.986085742350811,5215,16742,77.0,,6.0,,147,2030,2029,646220,9252
2021-10-31,S92000003,Scotland,2071,648291,11860.428100987923,329.43651664837176,16,9268,169.55726308086352,6727,2743291,50188.27296011709,23579,2215,9.393952245642309,7.970502734573882,6441,17138,80.0,,4.0,,160,2055,2071,648291,9268
2021-11-01,S92000003,Scotland,3301,651592,11920.819612147823,329.52799121844123,27,9295,170.05122575923895,10972,2754263,50389.00475667765,47916,3480,7.262709742048585,7.964302922729089,18332,29584,127.0,,9.0,,320,3160,3301,651592,9295
2021-11-02,S92000003,Scotland,3046,654638,11976.545920234175,331.9063300402488,13,9308,170.28905964141967,9686,2763949,50566.20929381632,45858,3243,7.071830433076018,8.008340476033492,19847,26011,104.0,,6.0,,276,2967,3046,654638,9308
2021-11-03,S92000003,Scotland,2983,657621,12031.119648737653,337.980241492865,16,9324,170.58177826564216,8103,2772052,50714.45298207098,38399,3137,8.16948358030157,8.077496029580141,15044,23355,87.0,,4.0,,254,2883,2983,657621,9324
2021-11-04,S92000003,Scotland,2798,660419,12082.308818148556,343.4870106110501,22,9346,170.98426637394806,7005,2779057,50842.60885473838,35554,2955,8.311301119423975,8.135586302599894,12218,23336,85.0,,6.0,,222,2733,2798,660419,9346
2021-11-05,S92000003,Scotland,2781,663200,12133.186974021222,347.76802049030374,17,9363,171.2952799121844,7020,2786077,50971.03915111599,31976,2942,9.2006504878659,8.216066775675973,10779,21197,87.0,,8.0,,241,2701,2781,663200,9363
2021-11-06,S92000003,Scotland,2226,665426,12173.911452616172,351.37211855104283,17,9380,171.6062934504208,5192,2791269,51066.02634467618,20714,2335,11.272569276817611,8.322677420941327,5342,15372,61.0,,5.0,,125,2210,2226,665426,9380
2021-11-07,S92000003,Scotland,2301,667727,12216.008049762166,355.5799487742408,12,9392,171.82583241858762,4647,2795916,51151.04281009879,21537,2428,11.273622138645123,8.480950924555907,6529,15008,77.0,,6.0,,163,2265,2301,667727,9392
2021-11-08,S92000003,Scotland,3821,671548,12285.912916209294,365.0933040614709,12,9404,172.04537138675448,9152,2805068,51318.47786315405,47051,4014,8.531168306730994,8.732874581586053,18411,28640,102.0,,12.0,,271,3743,3821,671548,9404
2021-11-09,S92000003,Scotland,3454,675002,12349.103549213318,372.5576289791438,6,9410,172.1551408708379,8884,2813952,51481.00987925357,45028,3648,8.101625655147908,8.931611302802391,19259,25769,97.0,,5.0,,306,3342,3454,675002,9410
2021-11-10,S92000003,Scotland,3292,678294,12409.330406147092,378.2107574094401,14,9424,172.41126966703257,7387,2821339,51616.15440907428,37886,3464,9.143219131077442,9.087117199035646,14919,22967,78.0,,6.0,,236,3228,3292,678294,9424
2021-11-11,S92000003,Scotland,3213,681507,12468.111964873766,385.8031467252104,8,9432,172.5576289791438,7098,2828437,51746.01170874497,36698,3415,9.305684233473212,9.23492050313421,12360,24338,94.0,,7.0,,248,3167,3213,681507,9432
2021-11-12,S92000003,Scotland,2856,684363,12520.362239297476,387.1752652762532,17,9449,172.86864251738015,6752,2835189,51869.53896816685,32989,3042,9.221255570038496,9.237586966676725,11144,21845,78.0,,7.0,,225,2817,2856,684363,9449
2021-11-13,S92000003,Scotland,2319,686682,12562.78814489572,388.8766922795463,10,9459,173.0515916575192,4642,2839831,51954.46395901939,20692,2478,11.975642760487144,9.297547140949474,5342,15350,50.0,,4.0,,106,2372,2319,686682,9459
2021-11-14,S92000003,Scotland,2424,689106,12607.135016465423,391.12696670325647,15,9474,173.32601536772776,4323,2844154,52033.5528723015,21493,2576,11.98529753873354,9.36043698855014,6115,15378,72.0,,6.0,,155,2421,2424,689106,9474
2021-11-15,S92000003,Scotland,3642,692748,12673.765093304062,387.8521770947677,19,9493,173.67361873399193,7756,2851910,52175.44822539334,44368,3838,8.650378651280203,9.391856293434357,18090,26278,82.0,,13.0,,232,3606,3642,692748,9493
2021-11-16,S92000003,Scotland,3279,696027,12733.754116355653,384.65056714233447,5,9498,173.76509330406148,7644,2859554,52315.29454811562,43925,3476,7.913488901536709,9.363119667634248,19760,24165,98.0,,3.0,,250,3226,3279,696027,9498
2021-11-17,S92000003,Scotland,3315,699342,12794.401756311749,385.07135016465423,12,9510,173.9846322722283,6555,2866109,52435.21770947677,36751,3500,9.523550379581508,9.42317108173361,14438,22313,70.0,,6.0,,247,3253,3315,699342,9510
2021-11-18,S92000003,Scotland,2992,702334,12849.140139041345,381.0281741675814,9,9519,174.14928649835346,6141,2872250,52547.56677643615,34825,3138,9.010768126346017,9.380411243900053,11899,22926,76.0,,11.0,,209,2929,2992,702334,9519
2021-11-19,S92000003,Scotland,2785,705119,12900.091474570068,379.7292352725942,9,9528,174.31394072447858,5399,2877649,52646.34101719722,30102,2987,9.922928709055876,9.473371353744897,10607,19495,61.0,,1.0,,173,2814,2785,705119,9528
2021-11-20,S92000003,Scotland,2215,707334,12940.614709110869,377.8265642151482,10,9538,174.49688986461763,4037,2881686,52720.19758507135,19347,2354,12.16726107406833,9.474851718505615,5058,14289,48.0,,6.0,,91,2263,2215,707334,9538
2021-11-21,S92000003,Scotland,2174,709508,12980.387852177097,373.25283571167216,9,9547,174.66154409074278,3884,2885570,52791.25503110136,20301,2299,11.32456529235013,9.40340302849503,6371,13930,48.0,,6.0,,95,2204,2174,709508,9547
2021-11-22,S92000003,Scotland,3160,712668,13038.199780461033,364.4346871569704,15,9562,174.93596780095135,7209,2892779,52923.14306622758,42712,3338,7.815133920209777,9.252378675486812,18172,24540,80.0,,8.0,,202,3136,3160,712668,9562
2021-11-23,S92000003,Scotland,2880,715548,13090.889132821076,357.1350164654226,12,9574,175.15550676911818,7044,2899823,53052.012440541526,41637,3066,7.363642913754593,9.164506480558323,19487,22150,60.0,,8.0,,207,2859,2880,715548,9574
2021-11-24,S92000003,Scotland,2895,718443,13143.85290889133,349.45115257958287,5,9579,175.2469813391877,5768,2905591,53157.53750457373,34417,3102,9.012987767672952,9.082076286933434,14241,20176,81.0,,5.0,,217,2885,2895,718443,9579
2021-11-25,S92000003,Scotland,2491,720934,13189.425539699963,340.2854006586169,10,9589,175.42993047932674,5391,2910982,53256.16538602268,32087,2652,8.265029451179604,8.974492640625922,11704,20383,62.0,,4.0,,168,2484,2491,720934,9589
2021-11-26,S92000003,Scotland,2237,723171,13230.351262349066,330.25978777899746,14,9603,175.68605927552142,4594,2915576,53340.21222100256,27305,2379,8.712689983519502,8.810592912959239,10702,16603,56.0,,4.0,,174,2205,2237,723171,9603
2021-11-27,S92000003,Scotland,1882,725053,13264.782290523231,324.1675814123674,13,9616,175.92389315770217,3480,2919056,53403.87852177095,17527,2023,11.54219204655674,8.731584454547981,5231,12296,56.0,,7.0,,136,1887,1882,725053,9616
2021-11-28,S92000003,Scotland,2332,727385,13307.44603000366,327.05817782656425,16,9632,176.21661178192463,3756,2922812,53472.59421880717,20131,2453,12.18518702498634,8.809819475849798,5988,14143,50.0,,5.0,,140,2313,2332,727385,9632
2021-11-29,S92000003,Scotland,3457,730842,13370.691547749724,332.4917672886937,9,9641,176.38126600804978,6962,2929774,53599.96341017197,43994,3653,8.30340500977406,8.902891781591723,18066,25928,76.0,,3.0,,247,3406,3457,730842,9641
2021-11-30,S92000003,Scotland,3295,734137,13430.97328942554,340.08415660446394,3,9644,176.43615075009146,7305,2937079,53733.607757043545,44095,3491,7.916997391994557,8.996793528758039,19520,24575,59.0,,9.0,,239,3252,3295,734137,9644
2021-12-01,S92000003,Scotland,3092,737229,13487.541163556532,343.68825466520303,14,9658,176.69227954628613,6983,2944062,53861.36114160264,39341,3294,8.372944256627946,8.884978617248752,14447,24894,56.0,,2.0,,187,3107,3092,737229,9658
2021-12-02,S92000003,Scotland,2924,740153,13541.03549213319,351.60995243322355,11,9669,176.8935236004391,6727,2950789,53984.43102817416,37637,3133,8.324255386986211,8.879711341998869,11984,25653,49.0,,5.0,,175,2958,2924,740153,9669
2021-12-03,S92000003,Scotland,2639,742792,13589.31577021588,358.96450786681305,6,9675,177.0032930845225,6230,2957019,54098.40834248078,33054,2835,8.57687420584498,8.856598764096887,10424,22630,41.0,,3.0,,148,2687,2639,742792,9675
2021-12-04,S92000003,Scotland,2117,744909,13628.046103183317,363.2638126600805,11,9686,177.20453713867545,4670,2961689,54183.845590925725,21714,2286,10.527770102238188,8.811664985872998,5216,16498,53.0,,4.0,,122,2164,2117,744909,9686
2021-12-05,S92000003,Scotland,2481,747390,13673.435784851812,365.9897548481522,7,9693,177.33260153677276,4910,2966599,54273.673618734,24217,2654,10.959243506627574,8.74649664825529,5955,18262,41.0,,0.0,,128,2526,2481,747390,9693
2021-12-06,S92000003,Scotland,3761,751151,13742.242956458103,371.5514087083791,8,9701,177.478960848884,8830,2975429,54435.21770947677,49608,4003,8.06926302209321,8.690009853163827,18073,31535,70.0,,5.0,,266,3737,3761,751151,9701
2021-12-07,S92000003,Scotland,3724,754875,13810.373216245884,379.399926820344,14,9715,177.73508964507866,9092,2984521,54601.55506769117,48542,3972,8.182604754645462,8.727219780176537,19720,28822,73.0,,5.0,,239,3733,3724,754875,9715
2021-12-08,S92000003,Scotland,4107,758982,13885.510428100988,397.9692645444567,1,9716,177.75338455909258,7996,2992517,54747.841200146366,45703,4402,9.631752838982123,8.93943756598522,15247,30456,,:,6.0,,236,4166,4107,758982,9716
2021-12-09,S92000003,Scotland,3935,762917,13957.500914745702,416.4654226125137,2,9718,177.7899743871204,7307,2999824,54881.52213684596,43003,4258,9.901634769667233,9.182180325833864,12381,30622,,:,0.0,,197,4061,3935,762917,9718
2021-12-10,S92000003,Scotland,3627,766544,14023.856567874132,434.540797658251,1,9719,177.8082693011343,6385,3006209,54998.33516282473,36398,3848,10.57200945106874,9.44443412522986,9885,26513,,:,3.0,,174,3674,3627,766544,9719
2021-12-11,S92000003,Scotland,3001,769545,14078.759604829858,450.7135016465423,0,9719,177.8082693011343,4170,3010379,55074.62495426272,23101,3208,13.886844725336566,9.736779858965452,4647,18454,,:,3.0,,138,3070,3001,769545,9719
2021-12-12,S92000003,Scotland,97,769642,14080.534211489206,407.0984266373948,0,9719,177.8082693011343,273,3010652,55079.619465788506,2134,114,5.342080599812558,9.579900921167535,1745,389,,:,5.0,,45,69,97,769642,9719
