Date,HB,HBName,DailyPositive,CumulativePositive,CrudeRatePositive,CrudeRate7DayPositive,DailyDeaths,CumulativeDeaths,CrudeRateDeaths,DailyNegative,CumulativeNegative,CrudeRateNegative,TotalTests,PositiveTests,PositivePercentage,PositivePercentage7Day,TotalPillar1,TotalPillar2,HospitalAdmissions,HospitalAdmissionsQF,ICUAdmissions,ICUAdmissionsQF,PositivePillar1,PositivePillar2,DailyCases,CumulativeCases,Deaths
2020-02-28,S92000003,Scotland,1,1,0.01829491401390413,,0,0,0.0,117,680,12.440541529454814,164,2,1.2195121951219512,,164,0,,:,,:,2,0,1,1,0
2020-02-29,S92000003,Scotland,0,1,0.01829491401390413,,0,0,0.0,63,743,13.593121112330772,90,0,0.0,,90,0,,:,,:,0,0,0,1,0
2020-03-01,S92000003,Scotland,2,3,0.054884742041712405,,0,0,0.0,70,813,14.873765093304062,92,2,2.1739130434782608,,92,0,6.0,,,:,2,0,2,3,0
2020-03-02,S92000003,Scotland,1,4,0.07317965605561652,,0,0,0.0,185,998,18.25832418587633,264,4,1.5151515151515151,,264,0,11.0,,,:,4,0,1,4,0
2020-03-03,S92000003,Scotland,3,7,0.12806439809732895,,0,0,0.0,206,1204,22.02707647274058,288,6,2.083333333333333,,288,0,13.0,,,:,6,0,3,7,0
2020-03-04,S92000003,Scotland,6,13,0.2378338821807537,,0,0,0.0,172,1376,25.17380168313209,255,10,3.92156862745098,,255,0,10.0,,,:,10,0,6,13,0
2020-03-05,S92000003,Scotland,2,15,0.27442371020856204,0.27442371020856204,0,0,0.0,169,1545,28.26564215148189,266,8,3.0075187969924815,2.2551092318534183,266,0,19.0,,,:,8,0,2,15,0
2020-03-06,S92000003,Scotland,6,21,0.3841931942919868,0.3658982802780827,0,0,0.0,188,1733,31.70508598609587,324,12,3.7037037037037033,2.6599113362887903,324,0,21.0,,,:,12,0,6,21,0
2020-03-07,S92000003,Scotland,6,27,0.4939626783754116,0.4756677643615075,0,0,0.0,119,1852,33.88218075375046,218,17,7.79816513761468,3.4563561804335086,218,0,10.0,,,:,17,0,6,27,0
2020-03-08,S92000003,Scotland,3,30,0.5488474204171241,0.4939626783754116,0,0,0.0,105,1957,35.80314672521039,192,17,8.854166666666668,4.095185390149418,192,0,11.0,,,:,17,0,3,30,0
2020-03-09,S92000003,Scotland,16,46,0.8415660446395901,0.7683863885839736,0,0,0.0,267,2224,40.687888766922796,453,39,8.609271523178807,5.460921843687375,453,0,18.0,,,:,39,0,16,46,0
2020-03-10,S92000003,Scotland,21,67,1.2257592389315772,1.0976948408342482,0,0,0.0,336,2560,46.83497987559458,588,47,7.993197278911565,6.533101045296168,588,0,30.0,,,:,47,0,21,67,0
2020-03-11,S92000003,Scotland,25,92,1.68313208927918,1.4452982070984266,0,0,0.0,400,2960,54.152945481156245,741,58,7.8272604588394055,7.117181883537023,741,0,29.0,,1.0,,58,0,25,92,0
2020-03-12,S92000003,Scotland,38,130,2.3783388218075374,2.103915111598975,1,1,0.01829491401390413,506,3466,63.410171972191726,893,80,8.958566629339305,7.9202112056321505,893,0,24.0,,0.0,,80,0,38,130,1
2020-03-13,S92000003,Scotland,48,178,3.256494694474936,2.8723015001829486,0,1,0.01829491401390413,514,3980,72.81375777533844,809,80,9.88875154511743,8.680020544427325,809,0,25.0,,0.0,,80,0,48,178,1
2020-03-14,S92000003,Scotland,19,197,3.604098060739114,3.1101353823637035,2,3,0.054884742041712405,316,4296,78.59495060373216,525,20,3.8095238095238098,8.117114972625565,525,0,21.0,,1.0,,20,0,19,197,3
2020-03-15,S92000003,Scotland,12,209,3.823637028905964,3.2747896084888404,0,3,0.054884742041712405,269,4565,83.51628247347237,428,28,6.5420560747663545,7.933288257831867,428,0,16.0,,1.0,,28,0,12,209,3
2020-03-16,S92000003,Scotland,21,230,4.20783022319795,3.36626417855836,1,4,0.07317965605561652,476,5041,92.22466154409072,713,35,4.908835904628331,7.4089844581647855,713,0,33.0,,3.0,,35,0,21,230,4
2020-03-17,S92000003,Scotland,43,273,4.994511525795828,3.768752286864252,2,6,0.1097694840834248,542,5583,102.1405049396268,853,62,7.2684642438452505,7.315598548972187,853,0,43.0,,1.0,,62,0,43,273,6
2020-03-18,S92000003,Scotland,41,314,5.744603000365897,4.061470911086719,0,6,0.1097694840834248,510,6093,111.47091108671788,895,56,6.256983240223464,7.056293979671619,895,0,43.0,,3.0,,56,0,41,314,6
2020-03-19,S92000003,Scotland,50,364,6.6593487010611065,4.281009879253569,3,9,0.16465422612513722,564,6657,121.78924259055981,946,61,6.4482029598308666,6.616366802089379,946,0,42.0,,4.0,,61,0,50,364,9
2020-03-20,S92000003,Scotland,84,448,8.196121478229053,4.939626783754116,5,14,0.2561287961946579,540,7197,131.66849615806805,946,97,10.253699788583507,6.765925367508482,946,0,73.0,,8.0,,97,0,84,448,14
2020-03-21,S92000003,Scotland,67,515,9.421880717160631,5.817782656421515,6,20,0.3658982802780827,423,7620,139.4072447859495,704,81,11.505681818181818,7.657247037374657,704,0,63.0,,6.0,,81,0,67,515,20
2020-03-22,S92000003,Scotland,74,589,10.775704354189537,6.952067325283571,5,25,0.4573728503476034,343,7963,145.68240029271863,682,90,13.19648093841642,8.398675727478652,682,0,52.0,,8.0,,90,0,74,589,25
2020-03-23,S92000003,Scotland,138,727,13.300402488108304,9.092572264910356,4,29,0.5305525064032199,566,8529,156.03732162458837,1074,164,15.270018621973929,10.016393442622949,1074,0,96.0,,12.0,,164,0,138,727,29
2020-03-24,S92000003,Scotland,167,894,16.355653128430298,11.361141602634465,7,36,0.6586169045005489,647,9176,167.87413099158434,1261,206,16.33624107850912,11.601106330669944,1261,0,96.0,,10.0,,206,0,167,894,36
2020-03-25,S92000003,Scotland,188,1082,19.795096963044273,14.050493962678376,11,47,0.8598609586534943,650,9826,179.76582510062204,1374,251,18.26783114992722,13.596679547731506,1374,0,123.0,,13.0,,251,0,188,1082,47
2020-03-26,S92000003,Scotland,223,1305,23.87486278814489,17.215514087083786,12,59,1.0793999268203442,738,10564,193.2674716428833,1459,269,18.437285812200138,15.44,1459,0,155.0,,15.0,,269,0,223,1305,59
2020-03-27,S92000003,Scotland,274,1579,28.887669227954632,20.691547749725572,11,70,1.2806439809732897,690,11254,205.89096231247711,1445,322,22.28373702422145,17.289661207650955,1445,0,150.0,,16.0,,322,0,274,1579,70
2020-03-28,S92000003,Scotland,204,1783,32.61983168679107,23.19795096963044,29,99,1.8111964873765092,589,11843,216.66666666666663,1204,259,21.51162790697675,18.366866690198847,1204,0,156.0,,17.0,,259,0,204,1783,99
2020-03-29,S92000003,Scotland,197,1980,36.223929747530185,25.44822539334065,20,119,2.1770947676545918,377,12220,223.5638492499085,948,262,27.637130801687764,19.7718197375927,948,0,136.0,,28.0,,262,0,197,1980,119
2020-03-30,S92000003,Scotland,317,2297,42.0234174899378,28.72301500182949,30,149,2.725942188071716,811,13031,238.40102451518482,1632,383,23.46813725490196,20.93746648074654,1632,0,193.0,,22.0,,383,0,317,2297,149
2020-03-31,S92000003,Scotland,341,2638,48.2619831686791,31.906330040248807,38,187,3.421148920600073,925,13956,255.32381997804612,1800,399,22.16666666666667,21.750152098965724,1800,0,184.0,,18.0,,399,0,341,2638,187
2020-04-01,S92000003,Scotland,389,3027,55.37870472008782,35.583607757043545,46,233,4.262714965239663,808,14764,270.10611050128057,1717,455,26.49970879440885,23.018128368446842,1717,0,216.0,,24.0,,455,0,389,3027,233
2020-04-02,S92000003,Scotland,351,3378,61.80021953896817,37.925356750823276,36,269,4.9213318697402135,734,15498,283.53457738748625,1618,416,25.710754017305323,24.083365495947515,1618,0,171.0,,18.0,,416,0,351,3378,269
2020-04-03,S92000003,Scotland,381,3759,68.77058177826564,39.882912550311005,58,327,5.9824368825466525,805,16303,298.2619831686792,1712,467,27.278037383177573,24.8424419151538,1712,0,212.0,,27.0,,467,0,381,3759,327
2020-04-04,S92000003,Scotland,260,4019,73.52725942188073,40.90742773508965,28,355,6.494694474935968,543,16846,308.19612147822914,1241,327,26.34971796937953,25.39370078740157,1241,0,154.0,,21.0,,327,0,260,4019,355
2020-04-05,S92000003,Scotland,225,4244,77.64361507500915,41.41968532747896,47,402,7.3545554335894625,469,17315,316.7764361507501,1117,294,26.32050134288273,25.292977761373077,1117,0,161.0,,25.0,,294,0,225,4244,402
2020-04-06,S92000003,Scotland,404,4648,85.03476033662642,43.01134284668861,63,465,8.507135016465423,797,18112,331.35748261983167,1798,522,29.032258064516128,26.17467963282741,1798,0,202.0,,15.0,,522,0,404,4648,465
2020-04-07,S92000003,Scotland,352,5000,91.47457006952068,43.21258690084157,49,514,9.403585803146727,767,18879,345.38968166849617,1696,449,26.474056603773583,26.883200293604922,1696,0,171.0,,16.0,,449,0,352,5000,514
2020-04-08,S92000003,Scotland,343,5343,97.7497255762898,42.371020856201966,54,568,10.391511159897547,734,19613,358.81814855470185,1657,417,25.16596258298129,26.681428176030998,1657,0,158.0,,13.0,,417,0,343,5343,568
2020-04-09,S92000003,Scotland,304,5647,103.31137943651665,41.511159897548474,66,634,11.59897548481522,771,20384,372.92352725942186,1653,389,23.5329703569268,26.347250321868678,1653,0,130.0,,12.0,,389,0,304,5647,634
2020-04-10,S92000003,Scotland,329,5976,109.33040614709113,40.55982436882547,58,692,12.660080497621662,762,21146,386.86425173801683,1691,403,23.83205204021289,25.808532203077487,1691,0,117.0,,8.0,,403,0,329,5976,692
2020-04-11,S92000003,Scotland,185,6161,112.71496523966336,39.18770581778266,50,742,13.574826198316867,517,21663,396.32272228320534,1184,261,22.04391891891892,25.33345683586513,1184,0,80.0,,9.0,,261,0,185,6161,742
2020-04-12,S92000003,Scotland,220,6381,116.73984632272229,39.096231247713135,48,790,14.452982070984266,448,22111,404.5188437614343,1062,294,27.683615819209038,25.463178475002326,1062,0,85.0,,8.0,,294,0,220,6381,790
2020-04-13,S92000003,Scotland,359,6740,123.30772045371387,38.27296011708746,41,831,15.203073545554336,722,22833,417.7277716794731,1575,429,27.23809523809524,25.11884388667047,1575,0,104.0,,8.0,,429,0,359,6740,831
2020-04-14,S92000003,Scotland,346,7086,129.6377607025247,38.16319063300403,51,882,16.136114160263446,717,23550,430.8452250274423,1629,438,26.887661141804784,25.17462443785284,1629,0,101.0,,6.0,,438,0,346,7086,882
2020-04-15,S92000003,Scotland,331,7417,135.69337724112697,37.94365166483717,42,924,16.90450054884742,838,24388,446.17636297109397,1740,399,22.931034482758623,24.80539206379343,1740,0,98.0,,6.0,,399,0,331,7417,924
2020-04-16,S92000003,Scotland,428,7845,143.52360043907794,40.212221002561286,43,967,17.6911818514453,950,25338,463.5565312843029,1969,513,26.053834433722702,25.225806451612907,1968,1,97.0,,9.0,,512,1,428,7845,967
2020-04-17,S92000003,Scotland,394,8239,150.73179656055618,41.40139041346506,38,1005,18.386388583973652,912,26250,480.24149286498357,1855,462,24.90566037735849,25.38587252587616,1855,0,110.0,,5.0,,462,0,394,8239,1005
2020-04-18,S92000003,Scotland,264,8503,155.56165386022687,42.84668862056349,52,1057,19.337724112696673,680,26930,492.6820343944384,1397,323,23.120973514674304,25.45648882159081,1397,0,74.0,,7.0,,323,0,264,8503,1057
2020-04-19,S92000003,Scotland,159,8662,158.4705451884376,41.730698865715325,46,1103,20.17929015733626,535,27465,502.4698133918769,1115,220,19.730941704035875,24.680851063829788,1115,0,58.0,,8.0,,220,0,159,8662,1103
2020-04-20,S92000003,Scotland,348,9010,164.83717526527627,41.52945481156239,61,1164,21.295279912184405,976,28441,520.3256494694475,1983,442,22.28946041351488,23.930527036276523,1983,0,65.0,,5.0,,442,0,348,9010,1164
2020-04-21,S92000003,Scotland,400,9410,172.1551408708379,42.51738016831321,51,1215,22.228320526893526,1001,29442,538.6388583973655,2123,476,22.42110221384833,23.272040715810213,2123,0,70.0,,5.0,,476,0,400,9410,1215
2020-04-22,S92000003,Scotland,340,9750,178.3754116355653,42.682034394438354,46,1261,23.06988657153311,1023,30465,557.3545554335894,2113,419,19.82962612399432,22.739944245320594,2113,0,66.0,,5.0,,419,0,340,9750,1261
2020-04-23,S92000003,Scotland,314,10064,184.1200146359312,40.59641419685328,49,1310,23.96633735821441,1025,31490,576.1068422978412,2034,396,19.469026548672566,21.695721077654518,2032,2,68.0,,7.0,,396,0,314,10064,1310
2020-04-24,S92000003,Scotland,306,10370,189.71825832418585,38.98646176362971,38,1348,24.661544090742773,1039,32529,595.1152579582875,1979,363,18.342597271349167,20.70778405524168,1978,1,91.0,,7.0,,363,0,306,10370,1348
2020-04-25,S92000003,Scotland,184,10554,193.08452250274425,37.52286864251738,48,1396,25.539699963410172,688,33217,607.7021587998536,1409,222,15.755855216465578,19.89651928504233,1406,3,42.0,,1.0,,222,0,184,10554,1396
2020-04-26,S92000003,Scotland,171,10725,196.21295279912187,37.742407610684225,43,1439,26.326381266008053,696,33913,620.4354189535309,1315,212,16.121673003802282,19.52763198518061,1205,110,39.0,,1.0,,204,8,171,10725,1439
2020-04-27,S92000003,Scotland,434,11159,204.15294548115622,39.31577021587999,60,1499,27.4240761068423,1803,35716,653.4211489206001,3362,536,15.942891136228434,18.304848273456575,2327,1035,76.0,,1.0,,435,101,434,11159,1499
2020-04-28,S92000003,Scotland,383,11542,211.1598975484815,39.004756677643606,40,1539,28.155872667398466,1851,37567,687.2850347603368,3394,463,13.64172068355922,16.730744585415867,2405,989,72.0,,1.0,,387,76,383,11542,1539
2020-04-29,S92000003,Scotland,431,11973,219.04500548847423,40.66959385290889,38,1577,28.85107939992682,2759,40326,737.7607025246982,4607,498,10.809637508139787,14.861878453038676,2671,1936,49.0,,7.0,,380,118,431,11973,1577
2020-04-30,S92000003,Scotland,337,12310,225.21039151115988,41.090376875228685,43,1620,29.637760702524695,2950,43276,791.7306988657152,4937,435,8.811018837350618,12.993381897824124,3013,1924,57.0,,4.0,,369,66,337,12310,1620
2020-05-01,S92000003,Scotland,375,12685,232.07098426637398,42.35272594218807,48,1668,30.515916575192094,3151,46427,849.3779729235272,5240,460,8.778625954198473,11.646884272997033,2934,2306,56.0,,6.0,,347,113,375,12685,1668
2020-05-02,S92000003,Scotland,222,12907,236.13245517746063,43.047932674716435,44,1712,31.320892791803878,2177,48604,889.2060007317966,3601,278,7.720077756178839,10.893559117024495,1834,1767,47.0,,3.0,,198,80,222,12907,1712
2020-05-03,S92000003,Scotland,188,13095,239.57189901207462,43.358946212952794,37,1749,31.997804610318326,1974,50578,925.3201609952432,3541,244,6.8907088393109275,10.159682030541802,1721,1820,40.0,,2.0,,156,88,188,13095,1749
2020-05-04,S92000003,Scotland,330,13425,245.60922063666303,41.45627515550677,40,1789,32.729601170874496,2442,53020,969.9963410171972,4592,434,9.451219512195124,9.400909334046537,3087,1505,52.0,,3.0,,370,64,330,13425,1789
2020-05-05,S92000003,Scotland,288,13713,250.87815587266738,39.71825832418588,50,1839,33.6443468715697,2629,55649,1018.0936699597513,4702,382,8.124202467035305,8.747597693786034,3098,1604,40.0,,2.0,,301,81,288,13713,1839
2020-05-06,S92000003,Scotland,307,14020,256.49469447493595,37.44968898646177,43,1882,34.43102817416757,2882,58531,1070.8196121478231,5031,422,8.387994434506062,8.390216154721273,3180,1851,46.0,,2.0,,329,93,307,14020,1882
2020-05-07,S92000003,Scotland,297,14317,261.9282839370655,36.717892425905596,40,1922,35.16282473472375,2750,61281,1121.1306256860594,4910,394,8.024439918533602,8.267704083246356,3228,1682,37.0,,0.0,,313,81,297,14317,1922
2020-05-08,S92000003,Scotland,258,14575,266.6483717526528,34.577387486278816,34,1956,35.784851811196496,2710,63991,1170.7098426637394,4799,344,7.168160033340279,8.012573774698486,3184,1615,33.0,,4.0,,261,83,258,14575,1956
2020-05-09,S92000003,Scotland,180,14755,269.9414562751556,33.80900109769484,34,1990,36.40687888766922,1830,65821,1204.189535309184,3508,246,7.012542759407071,7.933597143132903,2114,1394,21.0,,1.0,,167,79,180,14755,1990
2020-05-10,S92000003,Scotland,153,14908,272.7405781192828,33.1686791072082,28,2018,36.91913648005855,1710,67531,1235.4738382729602,3203,212,6.618794879800188,7.916734428362335,1942,1261,28.0,,1.0,,156,56,153,14908,2018
2020-05-11,S92000003,Scotland,265,15173,277.58873033296743,31.979509696304426,32,2050,37.50457372850347,3123,70654,1292.6088547383831,5786,364,6.291047355686137,7.4016093177619835,4183,1603,33.0,,2.0,,278,86,265,15173,2050
2020-05-12,S92000003,Scotland,230,15403,281.7965605561654,30.918404683497982,31,2081,38.071716062934506,2835,73489,1344.474935967801,5413,326,6.0225383336412355,7.068912710566616,3964,1449,37.0,,0.0,,257,69,230,15403,2081
2020-05-13,S92000003,Scotland,198,15601,285.41895353091843,28.924259055982443,42,2123,38.840102451518476,3186,76675,1402.7625320160996,5518,268,4.856832185574484,6.50028668859583,3670,1848,28.0,,0.0,,196,72,198,15601,2123
2020-05-14,S92000003,Scotland,211,15812,289.2791803878522,27.35089645078668,35,2158,39.480424442005116,3554,80229,1467.782656421515,6194,293,4.730384242815628,5.964382208535488,4184,2010,28.0,,1.0,,218,75,211,15812,2158
2020-05-15,S92000003,Scotland,151,15963,292.0417124039517,25.393340651298928,26,2184,39.956092206366634,2919,83148,1521.185510428101,5354,238,4.445274561075832,5.566674290942362,3545,1809,34.0,,2.0,,172,66,151,15963,2184
2020-05-16,S92000003,Scotland,103,16066,293.9260885473838,23.98463227222832,29,2213,40.48664471276985,2085,85233,1559.330406147091,3998,149,3.726863431715858,5.21626346359894,2232,1766,19.0,,0.0,,97,52,103,16066,2213
2020-05-17,S92000003,Scotland,93,16159,295.62751555067695,22.88693743139407,26,2239,40.962312477131356,1675,86908,1589.9743871203805,3487,130,3.728133065672498,4.945454545454545,2252,1235,10.0,,1.0,,83,47,93,16159,2239
2020-05-18,S92000003,Scotland,141,16300,298.2070984266374,20.61836809366996,23,2262,41.383095499451144,3387,90295,1651.939260885474,6306,229,3.6314620995876936,4.502343534601598,4413,1893,29.0,,1.0,,180,49,141,16300,2262
2020-05-19,S92000003,Scotland,182,16482,301.53677277716787,19.740212221002558,28,2290,41.89535309184047,3776,94071,1721.020856201976,6619,253,3.822329657047893,4.1626641050272175,3993,2626,14.0,,2.0,,191,62,182,16482,2290
2020-05-20,S92000003,Scotland,121,16603,303.7504573728504,18.331503841931948,22,2312,42.29784120014636,3893,97964,1792.2429564581046,6621,187,2.824346775411569,3.833691904922367,4153,2468,19.0,,0.0,,138,49,121,16603,2312
2020-05-21,S92000003,Scotland,111,16714,305.78119282839367,16.50201244054153,24,2336,42.73691913648005,3182,101146,1850.4573728503478,5943,171,2.8773346794548207,3.5404925902734288,3957,1986,13.0,,0.0,,123,48,111,16714,2336
2020-05-22,S92000003,Scotland,91,16805,307.44603000365896,15.404317599707284,17,2353,43.047932674716435,2927,104073,1904.006586169045,5361,156,2.909904868494684,3.325942350332594,3538,1823,16.0,,1.0,,104,52,91,16805,2353
2020-05-23,S92000003,Scotland,50,16855,308.3607757043542,14.434687156970362,11,2364,43.24917672886937,1885,105958,1938.4924990852546,3843,104,2.7062190996617232,3.2215819800942898,2429,1414,14.0,,0.0,,70,34,50,16855,2364
2020-05-24,S92000003,Scotland,53,16908,309.33040614709114,13.702890596414196,8,2372,43.39553604098061,1847,107805,1972.2832052689355,3733,96,2.571658183766408,3.1124759277572482,2129,1604,8.0,,1.0,,57,39,53,16908,2372
2020-05-25,S92000003,Scotland,96,17004,311.0867178924259,12.879619465788512,14,2386,43.651664837175254,2892,110697,2025.1920965971453,5658,155,2.7394839165782963,2.969982529514533,3968,1690,15.0,,1.0,,105,50,96,17004,2386
2020-05-26,S92000003,Scotland,478,17482,319.83168679107206,18.294914013904133,14,2400,43.90779363336992,4599,115296,2109.3304061470913,8603,553,6.4279902359642,3.5762788592123127,3867,4736,14.0,,0.0,,84,469,478,17482,2400
2020-05-27,S92000003,Scotland,66,17548,321.03915111598974,17.288693743139408,16,2416,44.20051225759239,2619,117915,2157.244785949506,5126,109,2.126414358174015,3.5121645281835527,3463,1663,11.0,,0.0,,84,25,66,17548,2416
2020-05-28,S92000003,Scotland,55,17603,322.0453713867545,16.264178558360776,16,2432,44.49323088181485,2498,120413,2202.9454811562387,4942,105,2.1246458923512748,3.4293994525841245,3451,1491,7.0,,0.0,,69,36,55,17603,2432
2020-05-29,S92000003,Scotland,30,17633,322.5942188071716,15.148188803512626,11,2443,44.6944749359678,2115,122528,2241.6392242956463,4431,61,1.3766644098397651,3.255724350506385,3166,1265,11.0,,0.0,,38,23,30,17633,2443
2020-05-30,S92000003,Scotland,40,17673,323.3260153677278,14.965239663373582,6,2449,44.80424442005122,1470,123998,2268.532747896085,3269,79,2.4166411746711534,3.2380739332252118,2460,809,4.0,,0.0,,49,30,40,17673,2449
2020-05-31,S92000003,Scotland,23,17696,323.7467983900476,14.416392242956462,6,2455,44.914013904134656,1554,125552,2296.963044273692,3309,54,1.6319129646418855,3.1580734619955857,2489,820,11.0,,0.0,,37,17,23,17696,2455
2020-06-01,S92000003,Scotland,38,17734,324.44200512257595,13.35528723015002,3,2458,44.968898646176356,2205,127757,2337.3033296743506,4682,88,1.8795386586928664,3.052790873639485,3547,1135,6.0,,1.0,,65,23,38,17734,2458
2020-06-02,S92000003,Scotland,46,17780,325.2835711672156,5.451884376143432,6,2464,45.07866813025979,2464,130221,2382.381997804611,5249,88,1.6765098113926462,1.8833849329205368,3951,1298,5.0,,1.0,,70,18,46,17780,2464
2020-06-03,S92000003,Scotland,34,17814,325.90559824368825,4.8664471276985,8,2472,45.22502744237102,2502,132723,2428.1558726673984,5206,70,1.3446023818670765,1.7530880082346885,3688,1518,9.0,,1.0,,45,25,34,17814,2472
2020-06-04,S92000003,Scotland,35,17849,326.5459202341749,4.5005488474204185,1,2473,45.24332235638492,2446,135169,2472.905232345408,5267,75,1.4239605088285552,1.6394486359150668,3742,1525,8.0,,0.0,,69,6,35,17849,2473
2020-06-05,S92000003,Scotland,24,17873,326.9849981705086,4.390779363336994,9,2482,45.40797658251006,2565,137734,2519.831686791072,5050,50,0.99009900990099,1.5734265734265735,3395,1655,10.0,,0.0,,41,9,24,17873,2482
2020-06-06,S92000003,Scotland,22,17895,327.3874862788145,4.061470911086719,3,2485,45.46286132455178,1916,139650,2554.884742041713,3836,39,1.0166840458811262,1.4233565446792846,2572,1264,7.0,,0.0,,27,12,22,17895,2485
2020-06-07,S92000003,Scotland,17,17912,327.69849981705084,3.951701427003293,7,2492,45.5909257226491,1515,141165,2582.6015367727773,3384,28,0.8274231678486997,1.3405153945032748,2271,1113,7.0,,1.0,,14,14,17,17912,2492
2020-06-08,S92000003,Scotland,18,17930,328.0278082693012,3.5858031467252105,6,2498,45.70069520673253,2718,143883,2632.3271130625685,5728,64,1.11731843575419,1.2277580071174377,3900,1828,4.0,,0.0,,51,13,18,17930,2498
2020-06-09,S92000003,Scotland,27,17957,328.5217709476765,3.2381997804610316,1,2499,45.71899012074643,2935,146818,2686.0226856933773,5980,69,1.153846153846154,1.1465559780557897,4249,1731,9.0,,0.0,,55,14,27,17957,2499
2020-06-10,S92000003,Scotland,29,17986,329.05232345407984,3.1467252103915118,5,2504,45.81046469081596,3134,149952,2743.358946212953,6100,59,0.9672131147540984,1.086433724713538,3917,2183,8.0,,1.0,,49,10,29,17986,2504
2020-06-11,S92000003,Scotland,21,18007,329.4365166483717,2.890596414196853,2,2506,45.847054518843755,2708,152660,2792.901573362605,6184,48,0.7761966364812419,0.984501682201754,4244,1940,7.0,,0.0,,42,6,21,18007,2506
2020-06-12,S92000003,Scotland,30,18037,329.9853640687889,3.0003658982802786,2,2508,45.88364434687157,2828,155488,2844.6395901939263,6028,46,0.7631055076310551,0.947905477980666,3936,2092,4.0,,0.0,,36,10,30,18037,2508
2020-06-13,S92000003,Scotland,22,18059,330.3878521770948,3.0003658982802786,3,2511,45.93852908891328,1790,157278,2877.387486278815,4101,34,0.8290660814435503,0.9278762831622452,2611,1490,6.0,,0.0,,26,8,22,18059,2511
2020-06-14,S92000003,Scotland,13,18072,330.6256860592755,2.927186242224661,4,2515,46.0117087449689,1580,158858,2906.2934504207833,3717,24,0.645682001614205,0.909138960833025,2409,1308,6.0,,0.0,,15,9,13,18072,2515
2020-06-15,S92000003,Scotland,21,18093,331.0098792535676,2.9820709842663735,3,2518,46.066593487010614,2783,161641,2957.208196121478,6204,45,0.7253384912959381,0.8482539019679489,4215,1989,8.0,,0.0,,37,8,21,18093,2518
2020-06-16,S92000003,Scotland,17,18110,331.3208927918039,2.7991218441273324,6,2524,46.176362971094036,2878,164519,3009.8609586534944,6702,30,0.4476275738585497,0.7326570345322266,4266,2436,6.0,,1.0,,23,7,17,18110,2524
2020-06-17,S92000003,Scotland,33,18143,331.9246249542627,2.8723015001829486,3,2527,46.23124771313574,3122,167641,3066.9776802049028,7235,49,0.6772633033863165,0.6870628065022031,3954,3281,6.0,,1.0,,38,11,33,18143,2527
2020-06-18,S92000003,Scotland,14,18157,332.18075375045737,2.74423710208562,3,2530,46.28613245517746,2960,170601,3121.1306256860594,7281,35,0.4807032001098751,0.6372976640496268,3715,3566,5.0,,0.0,,24,11,14,18157,2530
2020-06-19,S92000003,Scotland,24,18181,332.6198316867911,2.6344676180021955,0,2530,46.28613245517746,2912,173513,3174.4054152945478,6812,39,0.5725190839694656,0.608770094169124,3618,3194,5.0,,0.0,,28,11,24,18181,2530
2020-06-20,S92000003,Scotland,6,18187,332.7296011708745,2.341748993779729,3,2533,46.34101719721917,1405,174918,3200.1097694840837,4026,10,0.24838549428713366,0.5526836124544393,2795,1231,2.0,,0.0,,5,5,6,18187,2533
2020-06-21,S92000003,Scotland,9,18196,332.89425539699965,2.268569337724113,2,2535,46.377607025246974,1303,176221,3223.9480424442004,3358,16,0.4764740917212627,0.5382286510644433,2405,953,1.0,,0.0,,12,4,9,18196,2535
2020-06-22,S92000003,Scotland,10,18206,333.0772045371387,2.0673252835711677,3,2538,46.4324917672887,3066,179287,3280.0402488108307,7219,31,0.4294223576672669,0.492576173386813,3882,3337,8.0,,0.0,,28,3,10,18206,2538
2020-06-23,S92000003,Scotland,20,18226,333.4431028174168,2.12221002561288,1,2539,46.4507866813026,4013,183300,3353.4577387486283,10258,30,0.2924546695262234,0.4546537054276992,4299,5959,6.0,,0.0,,16,14,20,18226,2539
2020-06-24,S92000003,Scotland,8,18234,333.589462129528,1.6648371752652764,1,2540,46.469081595316496,3540,186840,3418.221734357849,9795,17,0.17355793772332825,0.3651356950911813,3783,6012,5.0,,0.0,,9,8,8,18234,2540
2020-06-25,S92000003,Scotland,19,18253,333.9370654957922,1.756311745334797,0,2540,46.469081595316496,3130,189970,3475.4848152213685,8990,34,0.3781979977753059,0.35078679297633675,3561,5429,3.0,,0.0,,23,11,19,18253,2540
2020-06-26,S92000003,Scotland,6,18259,334.04683497987565,1.427003293084523,0,2540,46.469081595316496,2864,192834,3527.88144895719,8135,18,0.2212661339889367,0.3012688051601939,3318,4817,1.0,,0.0,,10,8,6,18259,2540
2020-06-27,S92000003,Scotland,4,18263,334.1200146359312,1.390413465056714,4,2544,46.54226125137212,1452,194286,3554.445664105379,3936,10,0.2540650406504065,0.3017933489388868,2483,1453,4.0,,0.0,,7,3,4,18263,2544
2020-06-28,S92000003,Scotland,3,18266,334.17489937797296,1.2806439809732897,1,2545,46.56055616538602,1140,195426,3575.301866081229,3279,6,0.18298261665141813,0.28287995039913205,2321,958,4.0,,0.0,,4,2,3,18266,2545
2020-06-29,S92000003,Scotland,14,18280,334.43102817416764,1.3538236370289058,1,2546,46.57885107939993,2884,198310,3628.064398097329,8448,22,0.26041666666666663,0.25926837115118945,3969,4479,3.0,,0.0,,14,8,14,18280,2546
2020-06-30,S92000003,Scotland,8,18288,334.5773874862788,1.1342846688620565,0,2546,46.57885107939993,3525,201835,3692.553969996341,12223,19,0.1554446535220486,0.22990183556544905,4030,8193,1.0,,0.0,,10,9,8,18288,2546
2020-07-01,S92000003,Scotland,11,18299,334.77863154043166,1.1891694109037687,0,2546,46.57885107939993,3410,205245,3754.939626783754,11979,16,0.13356707571583604,0.21933672574135807,3767,8212,2.0,,0.0,,8,8,11,18299,2546
2020-07-02,S92000003,Scotland,13,18312,335.0164654226125,1.0793999268203442,0,2546,46.57885107939993,2910,208155,3808.177826564215,10378,17,0.16380805550202351,0.18500119908184592,3447,6931,2.0,,0.0,,5,12,13,18312,2546
2020-07-03,S92000003,Scotland,6,18318,335.12623490669586,1.0793999268203442,1,2547,46.59714599341383,2741,210896,3858.3241858763267,9122,10,0.10962508221881166,0.16844942306072602,3374,5748,2.0,,0.0,,4,6,6,18318,2547
2020-07-04,S92000003,Scotland,5,18323,335.2177094767655,1.0976948408342482,0,2547,46.59714599341383,1545,212441,3886.5898280278084,4369,8,0.18310826276035705,0.16388507976855413,2520,1849,2.0,,0.0,,6,2,5,18323,2547
2020-07-05,S92000003,Scotland,2,18325,335.25429930479334,1.0793999268203442,1,2548,46.61544090742774,1221,213662,3908.9279180387853,3414,6,0.17574692442882248,0.16351592611749788,2448,966,2.0,,0.0,,6,0,2,18325,2548
2020-07-06,S92000003,Scotland,8,18333,335.4006586169045,0.9696304427369192,0,2548,46.61544090742774,2710,216372,3958.507135016465,8973,18,0.20060180541624875,0.15547983724238315,4020,4953,4.0,,0.0,,13,5,8,18333,2548
2020-07-07,S92000003,Scotland,11,18344,335.60190267105736,1.0245151847786316,0,2548,46.61544090742774,3124,219496,4015.660446395903,12551,12,0.0956099115608318,0.14312506169183692,4201,8350,2.0,,0.0,,1,11,11,18344,2548
2020-07-08,S92000003,Scotland,10,18354,335.7848518111965,1.0062202707647274,0,2548,46.61544090742774,3085,222581,4072.100256128796,13534,13,0.09605438155755874,0.13474278564668515,3586,9948,1.0,,1.0,,1,12,10,18354,2548
2020-07-09,S92000003,Scotland,8,18362,335.93121112330766,0.9147457006952068,0,2548,46.61544090742774,2870,225451,4124.6066593487,11869,11,0.09267840593141798,0.12219576388018548,3854,8015,1.0,,1.0,,2,9,8,18362,2548
2020-07-10,S92000003,Scotland,12,18374,336.1507500914745,1.0245151847786316,0,2548,46.61544090742774,2438,227889,4169.209659714599,8899,13,0.1460838296437802,0.12734047068811016,3471,5428,3.0,,0.0,,1,12,12,18374,2548
2020-07-11,S92000003,Scotland,9,18383,336.3154043175997,1.0976948408342482,0,2548,46.61544090742774,1574,229463,4198.0058543724845,4479,12,0.2679169457468185,0.13339820147836595,2700,1779,4.0,,0.0,,8,4,9,18383,2548
2020-07-12,S92000003,Scotland,2,18385,336.35199414562754,1.0976948408342482,0,2548,46.61544090742774,1292,230755,4221.6428832784495,3567,5,0.14017381553125874,0.1315130260521042,2429,1138,1.0,,0.0,,3,2,2,18385,2548
2020-07-13,S92000003,Scotland,18,18403,336.6813025978778,1.2806439809732897,0,2548,46.61544090742774,2916,233671,4274.990852542993,9704,24,0.24732069249793895,0.1393124158320821,4472,5232,1.0,,0.0,,8,16,18,18403,2548
2020-07-14,S92000003,Scotland,10,18413,336.86425173801683,1.262349066959385,0,2548,46.61544090742774,3291,236962,4335.1994145627505,14817,13,0.08773705878382937,0.13608697602775574,4901,9916,2.0,,0.0,,3,10,10,18413,2548
2020-07-15,S92000003,Scotland,16,18429,337.1569703622393,1.37211855104281,0,2548,46.61544090742774,2990,239952,4389.901207464325,14011,20,0.14274498608236386,0.1455171799364476,4150,9861,1.0,,0.0,,3,17,16,18429,2548
2020-07-16,S92000003,Scotland,21,18450,337.5411635565313,1.609952433223564,0,2548,46.61544090742774,2634,242586,4438.090010976948,11860,23,0.19392917369308602,0.16335744093143442,4280,7580,3.0,,0.0,,1,22,21,18450,2548
2020-07-17,S92000003,Scotland,8,18458,337.6875228686425,1.5367727771679471,0,2548,46.61544090742774,2487,245073,4483.589462129528,8946,10,0.111781801922647,0.15879140448771226,3688,5258,2.0,,0.0,,4,6,8,18458,2548
2020-07-18,S92000003,Scotland,13,18471,337.92535675082325,1.609952433223564,0,2548,46.61544090742774,1344,246417,4508.177826564215,4089,16,0.3912937148447053,0.1656864793862137,2699,1390,1.0,,0.0,,5,11,13,18471,2548
2020-07-19,S92000003,Scotland,17,18488,338.23637028905966,1.8843761434321256,0,2548,46.61544090742774,1634,248051,4538.071716062936,4049,17,0.4198567547542604,0.18228703539036104,2453,1596,2.0,,0.0,,3,14,17,18488,2548
2020-07-20,S92000003,Scotland,13,18501,338.4742041712404,1.7929015733626052,0,2548,46.61544090742774,3229,251280,4597.145993413831,10984,17,0.15477057538237435,0.16871254872302055,4967,6017,1.0,,0.0,,2,15,13,18501,2548
2020-07-21,S92000003,Scotland,19,18520,338.82180753750464,1.9575557994877424,0,2548,46.61544090742774,3227,254507,4656.1836809367,15045,22,0.14622798271851115,0.18120143801461208,4946,10099,2.0,,0.0,,2,20,19,18520,2548
2020-07-22,S92000003,Scotland,16,18536,339.11452616172704,1.9575557994877424,0,2548,46.61544090742774,3218,257725,4715.056714233443,15129,25,0.16524555489457335,0.1854440672163419,4512,10617,2.0,,0.0,,7,18,16,18536,2548
2020-07-23,S92000003,Scotland,23,18559,339.5353091840468,1.9941456275155507,0,2548,46.61544090742774,2902,260627,4768.148554701793,12843,26,0.20244491162500972,0.18709995076317085,4196,8647,3.0,,0.0,,3,23,23,18559,2548
2020-07-24,S92000003,Scotland,11,18570,339.73655323819975,2.049030369557263,0,2548,46.61544090742774,2632,263259,4816.300768386388,9814,15,0.15284287752190748,0.1917918641335316,4066,5748,1.0,,0.0,,2,13,11,18570,2548
2020-07-25,S92000003,Scotland,3,18573,339.7914379802415,1.8660812294182216,1,2549,46.63373582144164,1561,264820,4844.859129162092,4383,5,0.11407711613050422,0.1757858457790635,2570,1813,4.0,,1.0,,1,4,3,18573,2549
2020-07-26,S92000003,Scotland,7,18580,339.9195023783388,1.68313208927918,0,2549,46.63373582144164,1536,266356,4872.96011708745,4176,8,0.1915708812260536,0.16304197640036475,2725,1451,0.0,,0.0,,1,7,7,18580,2549
2020-07-27,S92000003,Scotland,13,18593,340.1573362605196,1.68313208927918,0,2549,46.63373582144164,3001,269357,4927.863154043176,10710,16,0.14939309056956115,0.16227461858529818,5064,5646,5.0,,0.0,,2,14,13,18593,2549
2020-07-28,S92000003,Scotland,22,18615,340.55982436882545,1.7380168313208928,0,2549,46.63373582144164,3076,272433,4984.138309549945,15975,26,0.16275430359937404,0.1656853347939203,4945,11030,0.0,,0.0,,3,23,22,18615,2549
2020-07-29,S92000003,Scotland,28,18643,341.07208196121485,1.9575557994877424,0,2549,46.63373582144164,3000,275433,5039.023051591657,15845,38,0.2398232881035027,0.1817047704282266,4290,11555,4.0,,0.0,,4,34,28,18643,2549
2020-07-30,S92000003,Scotland,27,18670,341.5660446395902,2.0307354555433594,0,2549,46.63373582144164,2855,278288,5091.255031101354,13415,32,0.23853894893775626,0.18837966576065016,4485,8930,4.0,,0.0,,3,29,27,18670,2549
2020-07-31,S92000003,Scotland,21,18691,341.95023783388217,2.2136845956824005,0,2549,46.63373582144164,2652,280940,5139.773143066228,9743,23,0.23606691983988504,0.19933465325198324,3980,5763,4.0,,0.0,,2,21,21,18691,2549
2020-08-01,S92000003,Scotland,22,18713,342.35272594218804,2.5612879619465794,0,2549,46.63373582144164,1763,282703,5172.02707647274,4874,26,0.5334427574887156,0.2261232572453103,2692,2182,1.0,,0.0,,4,22,22,18713,2549
2020-08-02,S92000003,Scotland,19,18732,342.70032930845224,2.7808269301134283,0,2549,46.63373582144164,2015,284718,5208.891328210758,4773,19,0.3980724910957469,0.238932766974182,2673,2100,2.0,,0.0,,0,19,19,18732,2549
2020-08-03,S92000003,Scotland,60,18792,343.7980241492865,3.6406878887669234,0,2549,46.63373582144164,3520,288238,5273.2894255397,12024,70,0.5821689953426481,0.30528774021839816,4946,7078,3.0,,0.0,,8,62,60,18792,2549
2020-08-04,S92000003,Scotland,57,18849,344.8408342480791,4.281009879253569,0,2549,46.63373582144164,4266,292504,5351.335528723015,17849,63,0.35296095019328816,0.3451218114437808,4984,12865,6.0,,0.0,,6,57,57,18849,2549
2020-08-05,S92000003,Scotland,64,18913,346.01170874496887,4.939626783754116,0,2549,46.63373582144164,4453,296957,5432.80278082693,18447,73,0.3957283027050469,0.377195685670262,4900,13547,7.0,,0.0,,8,65,64,18913,2549
2020-08-06,S92000003,Scotland,62,18975,347.14599341383104,5.579948774240762,0,2549,46.63373582144164,3946,300903,5504.994511525796,15929,73,0.4582836336242074,0.41487822666459423,4287,11642,2.0,,0.0,,7,66,62,18975,2549
2020-08-07,S92000003,Scotland,46,19021,347.9875594584705,6.0373216245883645,0,2549,46.63373582144164,3710,304613,5572.868642517379,12175,50,0.4106776180698152,0.4345249851866483,4445,7730,3.0,,0.0,,3,47,46,19021,2549
2020-08-08,S92000003,Scotland,27,19048,348.481522136846,6.1287961946578875,0,2549,46.63373582144164,2161,306774,5612.403951701427,5591,28,0.5008048649615454,0.4332396183804213,2727,2864,3.0,,0.0,,4,24,27,19048,2549
2020-08-09,S92000003,Scotland,26,19074,348.9571899012075,6.256860592755214,0,2549,46.63373582144164,1798,308572,5645.298207098426,4702,36,0.7656316461080391,0.4531983348132431,2645,2057,2.0,,0.0,,3,33,26,19074,2549
2020-08-10,S92000003,Scotland,57,19131,350.0,6.201975850713503,0,2549,46.63373582144164,4228,312800,5722.649103549214,13694,64,0.4673579669928435,0.4378471947232059,5431,8263,8.0,,0.0,,9,55,57,19131,2549
2020-08-11,S92000003,Scotland,64,19195,351.1708744968899,6.330040248810831,0,2549,46.63373582144164,4027,316827,5796.322722283206,18228,77,0.4224270353302612,0.4517495437442264,5151,13077,3.0,,0.0,,6,71,64,19195,2549
2020-08-12,S92000003,Scotland,48,19243,352.04903036955733,6.0373216245883645,0,2549,46.63373582144164,3525,320352,5860.8122941822185,16788,57,0.3395282344531808,0.4419851447070844,4538,12250,3.0,,0.0,,3,54,48,19243,2549
2020-08-13,S92000003,Scotland,52,19295,353.00036589828034,5.854372484449322,0,2549,46.63373582144164,3375,323727,5922.557628979143,15116,72,0.4763164858428155,0.4449903817183118,4546,10570,3.0,,0.0,,9,63,52,19295,2549
2020-08-14,S92000003,Scotland,50,19345,353.9151115989755,5.9275521405049405,0,2549,46.63373582144164,3720,327447,5990.614709110867,12294,62,0.5043110460387179,0.45826438151667,4548,7746,8.0,,0.0,,7,55,50,19345,2549
2020-08-15,S92000003,Scotland,20,19365,354.2810098792536,5.79948774240761,0,2549,46.63373582144164,2422,329869,6034.924990852543,6163,30,0.4867759208177835,0.4575501523251135,2893,3270,7.0,,1.0,,4,26,20,19365,2549
2020-08-16,S92000003,Scotland,30,19395,354.8298572996707,5.872667398463228,0,2549,46.63373582144164,2513,332382,6080.900109769484,5861,37,0.6312915884661321,0.4526683608640407,2749,3112,2.0,,0.0,,3,34,30,19395,2549
2020-08-17,S92000003,Scotland,72,19467,356.1470911086718,6.1470911086717885,0,2549,46.63373582144164,5660,338042,6184.449323088183,15881,85,0.5352307789182041,0.4649566593971062,5319,10562,9.0,,0.0,,7,78,72,19467,2549
2020-08-18,S92000003,Scotland,77,19544,357.5557994877424,6.384924990852543,0,2549,46.63373582144164,6109,344151,6296.212952799121,21854,87,0.3980964583142674,0.457656161861277,5804,16050,7.0,,0.0,,6,81,77,19544,2549
2020-08-19,S92000003,Scotland,91,19635,359.22063666300767,7.171606293450421,1,2550,46.65203073545554,6113,350264,6408.049762166118,21442,99,0.4617106613189068,0.4786484266461145,4896,16546,8.0,,0.0,,5,94,91,19635,2550
2020-08-20,S92000003,Scotland,140,19775,361.78192462495423,8.781558726673985,0,2550,46.65203073545554,6989,357253,6535.912916209294,20593,153,0.7429709124459768,0.5312812235800477,4746,15847,8.0,,0.0,,10,143,140,19775,2550
2020-08-21,S92000003,Scotland,90,19865,363.42846688620557,9.513355287230151,0,2550,46.65203073545554,7602,364855,6674.990852542993,18163,106,0.5836040301712272,0.5429395127186082,5027,13136,4.0,,0.0,,13,93,90,19865,2550
2020-08-22,S92000003,Scotland,47,19912,364.28832784485917,10.007317965605562,1,2551,46.670325649469454,5574,370429,6776.966703256494,10870,59,0.5427782888684453,0.5459429289053234,3177,7693,6.0,,0.0,,8,51,47,19912,2551
2020-08-23,S92000003,Scotland,65,19977,365.47749725576284,10.647639956092208,1,2552,46.688620563483354,6215,376644,6890.669593852909,11421,81,0.7092198581560284,0.5572930529677934,3133,8288,1.0,,0.0,,5,76,65,19977,2552
2020-08-24,S92000003,Scotland,60,20037,366.5751920965972,10.428100987925355,0,2552,46.688620563483354,11796,388440,7106.476399560922,24880,72,0.2893890675241157,0.5084234230748396,6090,18790,10.0,,1.0,,10,62,60,20037,2552
2020-08-25,S92000003,Scotland,69,20106,367.8375411635565,10.281741675814123,0,2552,46.688620563483354,11158,399598,7310.6110501280655,29447,87,0.2954460556253608,0.480206993334113,6029,23418,11.0,,0.0,,13,74,69,20106,2552
2020-08-26,S92000003,Scotland,97,20203,369.6121478229052,10.391511159897547,0,2552,46.688620563483354,11906,411504,7528.430296377607,30096,113,0.37546517809675706,0.4612634907541073,5799,24297,11.0,,0.0,,8,105,97,20203,2552
2020-08-27,S92000003,Scotland,99,20302,371.42334431028166,9.641419685327481,0,2552,46.688620563483354,11433,422937,7737.596048298573,24210,109,0.45022717885171415,0.4205598073608027,5204,19006,11.0,,1.0,,9,100,99,20302,2552
2020-08-28,S92000003,Scotland,104,20406,373.3260153677278,9.897548481522136,1,2553,46.706915477497255,9899,432836,7918.6974021222095,21537,116,0.5386079769698658,0.41781176825548827,5054,16483,5.0,,1.0,,20,96,104,20406,2553
2020-08-29,S92000003,Scotland,95,20501,375.06403219904877,10.775704354189537,0,2553,46.706915477497255,5911,438747,8026.838638858398,11241,110,0.9785606262788008,0.4501675041876047,3176,8065,4.0,,0.0,,7,103,95,20501,2553
2020-08-30,S92000003,Scotland,102,20603,376.9301134284669,11.452616172703989,0,2553,46.706915477497255,5651,444398,8130.223197950971,10866,113,1.0399411006810233,0.4728225536358085,3242,7624,3.0,,0.0,,10,103,102,20603,2553
2020-08-31,S92000003,Scotland,144,20747,379.56458104646913,12.989388949871936,0,2553,46.706915477497255,10116,454514,8315.294548115624,23254,155,0.6665519910553024,0.5330200264186763,6430,16824,4.0,,1.0,,15,140,144,20747,2553
2020-09-01,S92000003,Scotland,199,20946,383.20526893523595,15.367727771679473,0,2553,46.706915477497255,9966,464480,8497.621661178193,27409,214,0.7807654420080995,0.6257864386022758,6400,21009,4.0,,0.0,,34,180,199,20946,2553
2020-09-02,S92000003,Scotland,191,21137,386.6995975118917,17.087449688986467,1,2554,46.725210391511155,9443,473923,8670.380534211488,26178,203,0.7754603101841241,0.7049310618888005,5222,20956,9.0,,0.0,,12,191,191,21137,2554
2020-09-03,S92000003,Scotland,200,21337,390.35858031467245,18.93523600439078,1,2555,46.743505305525076,8282,482205,8821.899012074644,22294,219,0.9823270835202296,0.7914329138038507,5323,16971,5.0,,0.0,,13,206,200,21337,2555
2020-09-04,S92000003,Scotland,171,21508,393.4870106110502,20.16099524332236,1,2556,46.76180021953896,6825,489030,8946.761800219541,17487,195,1.1151140847486705,0.8714832515191488,5119,12368,17.0,,0.0,,22,173,171,21508,2556
2020-09-05,S92000003,Scotland,136,21644,395.97511891694114,20.911086717892424,0,2556,46.76180021953896,4326,493356,9025.90559824369,9327,148,1.5867910367749545,0.9114497679348024,3353,5974,9.0,,0.0,,8,140,136,21644,2556
2020-09-06,S92000003,Scotland,153,21797,398.7742407610685,21.844127332601534,0,2556,46.76180021953896,3677,497033,9093.175997072814,8054,165,2.0486714675937425,0.9693812825086006,3073,4981,8.0,,1.0,,10,155,153,21797,2556
2020-09-07,S92000003,Scotland,167,21964,401.8294914013904,22.264910354921327,0,2556,46.76180021953896,7547,504580,9231.247713135748,16543,198,1.1968808559511577,1.0542689249913584,6273,10270,16.0,,0.0,,35,163,167,21964,2556
2020-09-08,S92000003,Scotland,102,22066,403.6955726308087,20.490303695572628,0,2556,46.76180021953896,5045,509625,9323.545554335897,20278,115,0.5671170726896144,1.0344454523514286,6088,14190,14.0,,0.0,,21,94,102,22066,2556
2020-09-09,S92000003,Scotland,222,22288,407.75704354189537,21.057446030003657,0,2556,46.76180021953896,6094,515719,9435.034760336626,22641,243,1.0732741486683448,1.100116614076005,5607,17034,9.0,,1.0,,18,225,222,22288,2556
2020-09-10,S92000003,Scotland,216,22504,411.7087449688986,21.350164654226123,0,2556,46.76180021953896,5327,521046,9532.491767288691,18645,262,1.4052024671493697,1.1737109980084088,5566,13079,20.0,,1.0,,31,231,216,22504,2556
2020-09-11,S92000003,Scotland,209,22713,415.53238199780463,22.04537138675448,0,2556,46.76180021953896,4466,525512,9614.196853274787,14282,243,1.7014423750175045,1.2517081169718502,5364,8918,20.0,,1.0,,25,218,209,22713,2556
2020-09-12,S92000003,Scotland,207,22920,419.31942919868277,23.344310281741677,0,2556,46.76180021953896,3343,528855,9675.35675082327,8131,236,2.902472020661665,1.3465470554644758,3338,4793,16.0,,1.0,,23,213,207,22920,2556
2020-09-13,S92000003,Scotland,166,23086,422.35638492499083,23.58214416392243,1,2557,46.780095133552884,3254,532109,9734.888401024516,7300,191,2.616438356164384,1.3800779076238174,3095,4205,12.0,,0.0,,11,180,166,23086,2557
2020-09-14,S92000003,Scotland,177,23263,425.5945847054519,23.765093304061473,3,2560,46.83497987559458,5181,537290,9829.674350530551,17016,199,1.1694875411377526,1.3749734516543082,6406,10610,19.0,,0.0,,38,161,177,23263,2560
2020-09-15,S92000003,Scotland,227,23490,429.7475301866081,26.05195755579949,0,2560,46.83497987559458,4761,542051,9916.776436150749,21047,258,1.2258279089656483,1.4963965450844474,6626,14421,21.0,,0.0,,33,225,227,23490,2560
2020-09-16,S92000003,Scotland,268,23758,434.6505671423345,26.893523600439078,0,2560,46.83497987559458,4237,546288,9994.291986827662,20120,305,1.5159045725646123,1.5899982166489894,5717,14403,34.0,,1.0,,45,260,268,23758,2560
2020-09-17,S92000003,Scotland,254,24012,439.297475301866,27.588730332967444,1,2561,46.85327478960848,3929,550217,10066.172703988292,15935,296,1.8575462817696893,1.6642428561797535,5215,10720,21.0,,1.0,,36,260,254,24012,2561
2020-09-18,S92000003,Scotland,269,24281,444.2188071716063,28.686425173801684,2,2563,46.8898646176363,3680,553897,10133.497987559458,13006,301,2.3143164693218514,1.7415045585295694,5351,7655,14.0,,3.0,,30,271,269,24281,2563
2020-09-19,S92000003,Scotland,232,24513,448.463227222832,29.14379802414929,0,2563,46.8898646176363,2560,556457,10180.332967435052,6881,258,3.749455021072518,1.7847095404965203,3217,3664,19.0,,0.0,,29,229,232,24513,2563
2020-09-20,S92000003,Scotland,315,24828,454.22612513721185,31.869740212221004,3,2566,46.94474935967801,2816,559273,10231.851445298207,7261,343,4.7238672359179175,1.9354966128809277,3275,3986,19.0,,2.0,,31,312,315,24828,2566
2020-09-21,S92000003,Scotland,454,25282,462.53201609952436,36.937431394072455,2,2568,46.981339187705814,4636,563909,10316.666666666668,16238,483,2.9745042492917855,2.2331024599952234,6110,10128,28.0,,0.0,,76,407,454,25282,2568
2020-09-22,S92000003,Scotland,493,25775,471.5514087083791,41.803878521770955,2,2570,47.017929015733614,4571,568480,10400.292718624223,22076,529,2.3962674397535784,2.477417575381464,6624,15452,33.0,,1.0,,84,445,493,25775,2570
2020-09-23,S92000003,Scotland,567,26342,481.9246249542627,47.27405781192828,2,2572,47.054518843761436,4690,573170,10486.095865349433,21371,595,2.7841467409105802,2.7294488556749186,5744,15627,27.0,,3.0,,72,523,567,26342,2572
2020-09-24,S92000003,Scotland,715,27057,495.0054884742041,55.708013172338106,2,2574,47.09110867178924,4348,577518,10565.642151481889,18064,741,4.102081488042515,3.098277357789069,5501,12563,35.0,,1.0,,55,686,715,27057,2574
2020-09-25,S92000003,Scotland,577,27634,505.5616538602269,61.34284668862057,1,2575,47.10940358580314,3871,581389,10636.46176362971,13717,619,4.512648538310126,3.3785319293992884,4972,8745,35.0,,1.0,,59,560,577,27634,2575
2020-09-26,S92000003,Scotland,434,28068,513.5016465422613,65.03841931942921,2,2577,47.14599341383096,2860,584249,10688.785217709476,7934,474,5.974287874968491,3.5476884709500194,3477,4457,34.0,,3.0,,50,424,434,28068,2577
2020-09-27,S92000003,Scotland,357,28425,520.032930845225,65.80680570801317,2,2579,47.18258324185876,2718,586967,10738.510793999267,7224,401,5.55094130675526,3.603316326530612,3411,3813,35.0,,2.0,,54,347,357,28425,2579
2020-09-28,S92000003,Scotland,624,29049,531.4489571899012,68.91694109037688,3,2582,47.23746798390048,4387,591354,10818.770581778266,16211,677,4.176176670162236,3.786222876816421,5511,10700,45.0,,3.0,,99,578,624,29049,2582
2020-09-29,S92000003,Scotland,659,29708,543.505305525064,71.95389681668495,1,2583,47.25576289791438,4829,596183,10907.116721551407,23162,704,3.0394611864260423,3.9105522691604064,6924,16238,33.0,,2.0,,82,622,659,29708,2583
2020-09-30,S92000003,Scotland,794,30502,558.0314672521039,76.10684229784121,4,2587,47.32894255397,4539,600722,10990.15733626052,21769,846,3.8862602783775095,4.128385192587041,6095,15674,47.0,,4.0,,94,752,794,30502,2587
2020-10-01,S92000003,Scotland,778,31280,572.2649103549213,77.25942188071717,5,2592,47.420417124039524,4315,605037,11069.099890230515,19123,839,4.387386916278826,4.178119846069269,6195,12928,64.0,,2.0,,130,709,778,31280,2592
2020-10-02,S92000003,Scotland,817,32097,587.2118551042812,81.65020124405416,1,2593,47.43871203805342,4510,609547,11151.609952433226,15671,889,5.67289898538702,4.3476695411093305,5699,9972,54.0,,7.0,,113,776,817,32097,2593
2020-10-03,S92000003,Scotland,695,32792,599.9268203439442,86.42517380168312,3,2596,47.49359678009513,3556,613103,11216.666666666664,9717,771,7.934547699907379,4.542112210636357,3826,5891,46.0,,3.0,,85,686,695,32792,2596
2020-10-04,S92000003,Scotland,741,33533,613.4833516282472,93.45042078302231,3,2599,47.54848152213685,3721,616824,11284.742041712405,9788,788,8.05067429505517,4.776465900330039,3634,6154,46.0,,1.0,,83,705,741,33533,2599
2020-10-05,S92000003,Scotland,1098,34631,633.571167215514,102.12221002561287,2,2601,47.585071350164654,6314,623138,11400.256128796194,21043,1182,5.617069809437819,5.0044482136472865,7382,13661,73.0,,3.0,,168,1014,1098,34631,2601
2020-10-06,S92000003,Scotland,1189,35820,655.3238199780461,111.81851445298209,4,2605,47.65825100622028,5856,628994,11507.39114526162,25363,1267,4.995465836060403,5.374201871417606,7425,17938,94.0,,0.0,,229,1038,1189,35820,2605
2020-10-07,S92000003,Scotland,1251,37071,678.2107574094402,120.17929015733624,9,2614,47.82290523234541,5794,634788,11613.39187705818,24646,1332,5.4045281181530465,5.638566904133193,6739,17907,88.0,,5.0,,191,1141,1251,37071,2614
2020-10-08,S92000003,Scotland,1170,38241,699.6158068057082,127.35089645078669,11,2625,48.02414928649836,5473,640261,11713.519941456278,21448,1258,5.865348750466244,5.864062157335756,6489,14959,96.0,,3.0,,174,1084,1170,38241,2625
2020-10-09,S92000003,Scotland,1095,39336,719.6487376509331,132.436882546652,6,2631,48.13391877058178,5243,645504,11809.440175631174,16921,1190,7.03268128361208,6.040674495447002,5794,11127,81.0,,5.0,,215,975,1095,39336,2631
2020-10-10,S92000003,Scotland,938,40274,736.8093669959752,136.88254665203073,11,2642,48.33516282473472,3433,648937,11872.246615440908,9886,1043,10.55027311349383,6.243464115573803,3664,6222,75.0,,5.0,,153,890,938,40274,2642
2020-10-11,S92000003,Scotland,957,41231,754.3175997072814,140.834248079034,11,2653,48.536406878887675,3307,652244,11932.74789608489,9366,1053,11.242793081358103,6.4698887878575935,3332,6034,80.0,,4.0,,162,891,957,41231,2653
2020-10-12,S92000003,Scotland,1352,42583,779.0523234540798,145.4811562385657,8,2661,48.6827661909989,5734,657978,12037.650933040615,20839,1508,7.236431690580162,6.733920245351019,6905,13934,107.0,,9.0,,201,1307,1352,42583,2661
2020-10-13,S92000003,Scotland,1420,44003,805.0311013538237,149.70728137577748,12,2673,48.902305159165756,5579,663557,12139.718258324187,24920,1561,6.264044943820227,6.986862043647384,7425,17495,124.0,,9.0,,256,1305,1420,44003,2673
2020-10-14,S92000003,Scotland,1288,45291,828.5949506037323,150.38419319429198,6,2679,49.01207464324918,5386,668943,12238.25466520307,23677,1419,5.993157916965831,7.108620540387385,6290,17387,123.0,,5.0,,227,1192,1288,45291,2679
2020-10-15,S92000003,Scotland,1292,46583,852.2319795096962,152.6161727039883,16,2695,49.304793267471645,4918,673861,12328.229052323451,20280,1439,7.095660749506902,7.318351881419345,6342,13938,107.0,,11.0,,246,1193,1292,46583,2695
2020-10-16,S92000003,Scotland,1250,47833,875.1006220270766,155.45188437614343,20,2715,49.670691547749726,4694,678555,12414.105378704719,16076,1388,8.633988554366757,7.526150794920187,5545,10531,140.0,,8.0,,238,1150,1250,47833,2715
2020-10-17,S92000003,Scotland,854,48687,890.7244785949507,153.91511159897547,10,2725,49.853640687888756,3060,681615,12470.087815587269,8594,970,11.28694437979986,7.545736634559442,3198,5396,88.0,,3.0,,160,810,854,48687,2725
2020-10-18,S92000003,Scotland,832,49519,905.9458470545187,151.62824734723748,22,2747,50.25612879619466,2568,684183,12517.069154774974,7674,925,12.053687776909044,7.545469441258397,3193,4481,88.0,,7.0,,172,753,832,49519,2747
2020-10-19,S92000003,Scotland,1354,50873,930.7171606293449,151.66483717526526,16,2763,50.54884742041714,5174,689357,12611.727039882913,19880,1535,7.721327967806841,7.6275175266925945,6948,12932,140.0,,12.0,,294,1241,1354,50873,2763
2020-10-20,S92000003,Scotland,1688,52561,961.5989754848152,156.56787413099158,19,2782,50.89645078668131,5822,695179,12718.240029271863,26283,1856,7.061598752045048,7.783511889208258,7976,18307,138.0,,3.0,,319,1537,1688,52561,2782
2020-10-21,S92000003,Scotland,1578,54139,990.468349798756,161.87339919502378,11,2793,51.097694840834244,5367,700546,12816.428832784484,23938,1728,7.218648174450664,8.018741087797924,6335,17603,132.0,,8.0,,305,1423,1578,54139,2793
2020-10-22,S92000003,Scotland,1491,55630,1017.7460665934873,165.51408708379068,17,2810,51.4087083790706,5040,705586,12908.63519941456,20910,1661,7.943567670970827,8.157756069879616,6592,14318,137.0,,9.0,,345,1316,1491,55630,2810
2020-10-23,S92000003,Scotland,1280,56910,1041.1635565312843,166.06293450420782,18,2828,51.7380168313209,4751,710337,12995.554335894622,17200,1420,8.255813953488373,8.109801653290917,6182,11018,131.0,,7.0,,262,1158,1280,56910,2828
2020-10-24,S92000003,Scotland,948,57858,1058.5071350164653,167.78265642151482,20,2848,52.10391511159898,3266,713603,13055.305525064034,9886,1102,11.147076674084566,8.131445245724372,3774,6112,119.0,,9.0,,203,899,948,57858,2848
2020-10-25,S92000003,Scotland,937,58795,1075.6494694474936,169.70362239297475,23,2871,52.52469813391877,3140,716743,13112.751555067693,9034,1067,11.810936462253707,8.156153888508703,3557,5477,115.0,,10.0,,237,830,937,58795,2871
2020-10-26,S92000003,Scotland,1344,60139,1100.237833882181,169.5206732528357,31,2902,53.0918404683498,5775,722518,13218.404683497984,22064,1515,6.866388687454678,8.002938560878475,7976,14088,139.0,,9.0,,312,1203,1344,60139,2902
2020-10-27,S92000003,Scotland,1301,61440,1124.0395170142701,162.4405415294548,16,2918,53.38455909257227,5104,727622,13311.781924624956,24871,1481,5.95472638816292,7.7980969953793124,8185,16686,138.0,,8.0,,393,1088,1301,61440,2918
2020-10-28,S92000003,Scotland,1265,62705,1147.1825832418588,156.7142334431028,29,2947,53.91511159897549,4585,732207,13395.664105378704,23407,1458,6.228905882855557,7.618628898030964,7050,16357,131.0,,2.0,,347,1111,1265,62705,2947
2020-10-29,S92000003,Scotland,1096,63801,1167.2338090010976,149.48774240761068,29,2976,54.445664105378704,4321,736528,13474.716428832784,19969,1271,6.364865541589464,7.3668641393329155,6949,13020,103.0,,7.0,,276,995,1096,63801,2976
2020-10-30,S92000003,Scotland,1089,64890,1187.1569703622392,145.993413830955,35,3011,55.085986095865344,4079,740607,13549.3413830955,16070,1252,7.790914747977598,7.299223469884517,6474,9596,133.0,,10.0,,276,976,1089,64890,3011
2020-10-31,S92000003,Scotland,741,65631,1200.7135016465422,142.20636663007684,24,3035,55.52506403219905,2659,743266,13597.987559458472,8474,857,10.113287703563842,7.1846572334912695,3877,4597,105.0,,5.0,,224,633,741,65631,3035
2020-11-01,S92000003,Scotland,969,66600,1218.4412733260153,142.79180387852173,35,3070,56.1653860226857,3008,746274,13653.018660812293,8813,1126,12.776580052195618,7.245204903451175,3521,5292,105.0,,11.0,,249,877,969,66600,3070
2020-11-02,S92000003,Scotland,1474,68074,1245.4079765825102,145.1701427003293,30,3100,56.71423344310282,6006,752280,13762.8979143798,22717,1673,7.364528767002685,7.334239589449892,8075,14642,113.0,,8.0,,362,1311,1474,68074,3100
2020-11-03,S92000003,Scotland,1388,69462,1270.801317233809,146.76180021953897,35,3135,57.35455543358946,5692,757972,13867.032564946943,26746,1614,6.034547222014506,7.3306602427969185,8631,18115,119.0,,13.0,,419,1195,1388,69462,3135
2020-11-04,S92000003,Scotland,1300,70762,1294.5847054518845,147.40212221002562,19,3154,57.70215879985364,5252,763224,13963.117453347972,25003,1494,5.975282966044074,7.267278076874922,7741,17262,126.0,,5.0,,311,1183,1300,70762,3154
2020-11-05,S92000003,Scotland,1290,72052,1318.1851445298207,150.95133552872298,41,3195,58.452250274423704,5138,768362,14057.116721551409,22018,1521,6.907984376419293,7.345137514344468,7500,14518,101.0,,6.0,,366,1155,1290,72052,3195
2020-11-06,S92000003,Scotland,1131,73183,1338.8766922795462,151.719721917307,27,3222,58.94621295279912,4857,773219,14145.97511891694,18124,1334,7.3604060913705585,7.292922400394253,7143,10981,99.0,,7.0,,294,1040,1131,73183,3222
2020-11-07,S92000003,Scotland,837,74020,1354.189535309184,153.47603366264178,37,3259,59.62312477131357,3270,776489,14205.799487742404,9826,976,9.932831263993489,7.308232080271976,4004,5822,88.0,,5.0,,193,783,837,74020,3259
2020-11-08,S92000003,Scotland,873,74893,1370.1609952433225,151.719721917307,36,3295,60.28174167581411,2900,779389,14258.854738382726,9076,1001,11.029087703834287,7.200209722118193,3693,5383,82.0,,7.0,,233,768,873,74893,3295
2020-11-09,S92000003,Scotland,1295,76188,1393.8529088913285,148.44493230881815,42,3337,61.050128064398095,5866,785255,14366.172703988292,22873,1492,6.522974686311371,7.056394296230904,8647,14226,103.0,,4.0,,409,1083,1295,76188,3337
2020-11-10,S92000003,Scotland,1285,77473,1417.361873399195,146.560556165386,36,3373,61.70874496889864,5406,790661,14465.075009147457,26678,1448,5.4276932303770895,6.935732570846867,9122,17556,107.0,,5.0,,329,1119,1285,77473,3373
2020-11-11,S92000003,Scotland,1246,78719,1440.1573362605195,145.5726308086352,37,3410,62.385656787413104,5181,795842,14559.860958653497,25377,1438,5.666548449383299,6.874570805840026,8691,16686,116.0,,9.0,,339,1099,1246,78719,3410
2020-11-12,S92000003,Scotland,1194,79913,1462.0014635931213,143.8163190633004,32,3442,62.97109403585803,4831,800673,14648.243688254663,21064,1358,6.447018609950626,6.801335157647836,7519,13545,112.0,,8.0,,304,1054,1194,79913,3442
2020-11-13,S92000003,Scotland,1053,80966,1481.266008049762,142.3893157702159,38,3480,63.66630076838639,4888,805561,14737.66922795463,17599,1254,7.12540485254844,6.767904719494616,6972,10627,109.0,,6.0,,273,981,1053,80966,3480
2020-11-14,S92000003,Scotland,903,81869,1497.7863154043175,143.59678009513354,41,3521,64.41639224295646,3915,809476,14809.293816319065,11557,1079,9.336332958380202,6.757360829657885,4383,7174,100.0,,11.0,,253,826,903,81869,3521
2020-11-15,S92000003,Scotland,812,82681,1512.6417855836078,142.4807903402854,34,3555,65.03841931942921,3366,812842,14870.874496889866,9943,963,9.685205672332293,6.6858636030527565,3881,6062,95.0,,8.0,,219,744,812,82681,3555
2020-11-16,S92000003,Scotland,1273,83954,1535.9312111233075,142.0783022319795,33,3588,65.64215148188804,6140,818982,14983.205268935237,23803,1473,6.188295592992481,6.626182721785606,9097,14706,96.0,,6.0,,379,1094,1273,83954,3588
2020-11-17,S92000003,Scotland,1224,85178,1558.3241858763265,140.96231247713138,36,3624,66.30076838638858,6163,825145,15095.956824002926,28538,1429,5.007358609573201,6.523016224135307,9916,18622,111.0,,4.0,,430,999,1224,85178,3624
2020-11-18,S92000003,Scotland,1110,86288,1578.63154043176,138.47420417124042,24,3648,66.73984632272227,5532,830677,15197.164288327844,25883,1276,4.929876753081173,6.382102365106548,9118,16765,98.0,,8.0,,305,971,1110,86288,3648
2020-11-19,S92000003,Scotland,980,87268,1596.560556165386,134.55909257226492,25,3673,67.19721917306988,4829,835506,15285.510428100988,20409,1172,5.742564554853251,6.2774083001771555,7062,13347,97.0,,5.0,,320,852,980,87268,3673
2020-11-20,S92000003,Scotland,858,88126,1612.2575923893155,130.99158433955358,29,3702,67.72777167947311,4392,839898,15365.861690450056,17432,1049,6.0176686553464895,6.136008432377423,7190,10242,110.0,,10.0,,292,757,858,88126,3702
2020-11-21,S92000003,Scotland,762,88888,1626.1983168679105,128.41200146359313,33,3735,68.33150384193195,2943,842841,15419.703622392975,10072,895,8.886020651310563,6.067754262198707,4001,6071,87.0,,4.0,,249,646,762,88888,3735
2020-11-22,S92000003,Scotland,706,89594,1639.1145261617266,126.4727405781193,36,3771,68.99012074643251,2913,845754,15472.996706915475,9112,865,9.492976294995609,6.0325769506613725,3682,5430,68.0,,2.0,,204,661,706,89594,3771
2020-11-23,S92000003,Scotland,1153,90747,1660.2085620197586,124.27735089645078,31,3802,69.55726308086352,5554,851308,15574.606659348701,22966,1381,6.013236958982843,6.001696277118115,9159,13807,107.0,,8.0,,346,1035,1153,90747,3802
2020-11-24,S92000003,Scotland,990,91737,1678.3205268935235,119.99634101719722,30,3832,70.10611050128064,5348,856656,15672.447859495061,26749,1171,4.377733747055965,5.888118953725974,9516,17233,105.0,,12.0,,326,845,990,91737,3832
2020-11-25,S92000003,Scotland,929,92666,1695.3165020124404,116.68496158068056,32,3864,70.69154774972556,4747,861403,15759.293816319065,24130,1095,4.537919602154994,5.828684954535035,8438,15692,86.0,,6.0,,250,845,929,92666,3864
2020-11-26,S92000003,Scotland,799,93465,1709.9341383095498,113.37358214416392,23,3887,71.11233077204537,4910,866313,15849.121844127332,20740,971,4.681774349083896,5.660780024542496,7523,13217,104.0,,8.0,,248,723,799,93465,3887
2020-11-27,S92000003,Scotland,735,94200,1723.3809001097693,111.12330772045372,24,3911,71.55140870837906,4683,870996,15934.796926454443,17188,911,5.300209448452408,5.5659491283398355,7397,9791,92.0,,7.0,,259,652,735,94200,3911
2020-11-28,S92000003,Scotland,571,94771,1733.8272960117088,107.62897914379805,41,3952,72.30150018294914,3052,874048,15990.63300402488,9829,693,7.0505646556109465,5.421760484722372,4153,5676,63.0,,3.0,,161,532,571,94771,3952
2020-11-29,S92000003,Scotland,555,95326,1743.9809732894253,104.86644712769849,28,3980,72.81375777533844,2777,876825,16041.437980241491,8442,672,7.960199004975125,5.301282642797823,3559,4883,69.0,,4.0,,165,507,555,95326,3980
2020-11-30,S92000003,Scotland,972,96298,1761.7636297109402,101.55506769118185,32,4012,73.39919502378339,6656,883481,16163.208927918036,24479,1140,4.657052984190531,5.057123528204505,9481,14998,89.0,,6.0,,335,805,972,96298,4012
2020-12-01,S92000003,Scotland,923,97221,1778.649835345774,100.32930845225027,27,4039,73.89315770215879,6107,889588,16274.935967800951,27808,1089,3.916139240506329,4.954907401821802,9650,18158,84.0,,6.0,,325,764,923,97221,4039
2020-12-02,S92000003,Scotland,948,98169,1795.9934138309552,100.67691181851448,20,4059,74.25905598243688,5783,895371,16380.735455543358,26054,1118,4.291087740845936,4.901144640998959,8905,17149,102.0,,5.0,,329,789,948,98169,4059
2020-12-03,S92000003,Scotland,803,98972,1810.68422978412,100.75009147457008,36,4095,74.91767288693742,5019,900390,16472.557628979142,20640,962,4.6608527131782935,4.898095804819994,7229,13411,75.0,,4.0,,251,711,803,98972,4095
2020-12-04,S92000003,Scotland,646,99618,1822.502744237102,99.1218441273326,29,4124,75.44822539334065,4490,904880,16554.70179290158,17262,792,4.588112617309697,4.806934594168637,7326,9936,86.0,,5.0,,230,562,646,99618,4124
2020-12-05,S92000003,Scotland,662,100280,1834.6139773143066,100.78668130259787,19,4143,75.79582875960483,3579,908459,16620.179290157335,10211,781,7.648614239545587,4.8585577037124885,3745,6466,78.0,,3.0,,176,605,662,100280,4143
2020-12-06,S92000003,Scotland,643,100923,1846.3776070252468,102.39663373582144,29,4172,76.32638126600806,3282,911741,16680.22319795097,9893,747,7.550793490346709,4.861859813563921,4055,5838,66.0,,1.0,,180,567,643,100923,4172
2020-12-07,S92000003,Scotland,949,101872,1863.7394804244416,101.97585071350164,29,4201,76.85693377241127,5915,917656,16788.437614343213,24395,1104,4.525517524082804,4.838437433492585,10029,14366,92.0,,5.0,,303,801,949,101872,4201
2020-12-08,S92000003,Scotland,1040,102912,1882.7661909989026,104.11635565312841,28,4229,77.3691913648006,5528,923184,16889.571899012073,28025,1190,4.246208742194469,4.9047479484173495,10285,17740,106.0,,7.0,,326,864,1040,102912,4229
2020-12-09,S92000003,Scotland,996,103908,1900.9879253567508,104.99451152579584,23,4252,77.78997438712037,4947,928131,16980.07683863886,24867,1160,4.664816825511722,4.978823738109142,8734,16133,97.0,,3.0,,298,862,996,103908,4252
2020-12-10,S92000003,Scotland,891,104799,1917.2886937431394,106.60446395901937,23,4275,78.21075740944018,4324,932455,17059.18404683498,20203,1038,5.1378508142355095,5.051313994186392,7443,12760,94.0,,7.0,,274,764,891,104799,4275
2020-12-11,S92000003,Scotland,864,105663,1933.0954994511526,110.5927552140505,20,4295,78.57665568971827,4301,936756,17137.87047200878,17872,1015,5.679274843330349,5.1931850058317215,7699,10173,93.0,,5.0,,218,797,864,105663,4295
2020-12-12,S92000003,Scotland,677,106340,1945.4811562385653,110.86717892425906,23,4318,78.99743871203805,3186,939942,17196.15806805708,10120,772,7.628458498023716,5.190027700831025,4116,6004,69.0,,3.0,,131,641,677,106340,4318
2020-12-13,S92000003,Scotland,720,107060,1958.653494328577,112.2758873033297,26,4344,79.47310647639956,3146,943088,17253.713867544822,9838,824,8.375686115064036,5.24903931421815,3971,5867,70.0,,4.0,,177,647,720,107060,4344
2020-12-14,S92000003,Scotland,1083,108143,1978.4668862056349,114.7274057811928,31,4375,80.04024881083059,5464,948552,17353.677277716793,24158,1253,5.186687639705274,5.368551187047963,9888,14270,93.0,,6.0,,322,931,1083,108143,4375
2020-12-15,S92000003,Scotland,1033,109176,1997.3655323819974,114.59934138309549,32,4407,80.62568605927551,5325,953877,17451.097694840835,27802,1170,4.208330335947053,5.362598250037076,10007,17795,84.0,,8.0,,255,915,1033,109176,4407
2020-12-16,S92000003,Scotland,1028,110204,2016.1727039882917,115.18477863154042,31,4438,81.19282839370655,5032,958909,17543.1577021588,24815,1176,4.7390691114245405,5.376535517179988,8679,16136,114.0,,6.0,,310,866,1028,110204,4438
2020-12-17,S92000003,Scotland,911,111115,2032.839370654958,115.55067691181853,36,4474,81.8514452982071,4730,963639,17629.692645444567,21198,1043,4.920275497688461,5.340824576776655,7618,13580,99.0,,5.0,,287,756,911,111115,4474
2020-12-18,S92000003,Scotland,920,112035,2049.67069154775,116.57519209659716,23,4497,82.27222832052689,4883,968522,17719.02671057446,18643,1064,5.707235959877703,5.3465520523672145,7309,11334,89.0,,8.0,,275,789,920,112035,4497
2020-12-19,S92000003,Scotland,747,112782,2063.3369923161363,117.85583607757044,27,4524,82.76619099890229,3852,972374,17789.49871935602,11629,888,7.6360822082724225,5.3721312543904745,4341,7288,93.0,,8.0,,234,654,747,112782,4524
2020-12-20,S92000003,Scotland,812,113594,2078.1924624954268,119.53896816684963,29,4553,83.29674350530551,4204,976578,17866.41053787047,13112,950,7.245271507016474,5.336842179729338,4365,8747,70.0,,4.0,,201,749,812,113594,4553
2020-12-21,S92000003,Scotland,1304,114898,2102.049030369557,123.58214416392245,25,4578,83.75411635565312,6603,983181,17987.211855104284,30734,1512,4.919632979761827,5.2746851615258254,11081,19653,108.0,,10.0,,390,1122,1304,114898,4578
2020-12-22,S92000003,Scotland,1326,116224,2126.308086351994,128.94255396999634,28,4606,84.26637394804244,6324,989505,18102.908891328214,32415,1500,4.627487274409996,5.3315065619550825,9241,23174,105.0,,3.0,,303,1197,1326,116224,4606
2020-12-23,S92000003,Scotland,1313,117537,2150.32930845225,134.156604463959,35,4641,84.9066959385291,5564,995069,18204.70179290157,27703,1504,5.429014908132694,5.4434679671114425,8336,19367,106.0,,6.0,,265,1239,1313,117537,4641
2020-12-24,S92000003,Scotland,1017,118554,2168.935236004391,136.09586534943284,36,4677,85.56531284302964,3206,998275,18263.355287230148,13951,1140,8.171457243208371,5.775135470722804,4742,9209,95.0,,1.0,,205,935,1017,118554,4677
2020-12-25,S92000003,Scotland,515,119069,2178.3571167215514,128.6864251738017,35,4712,86.2056348335163,1162,999437,18284.613977314308,4510,598,13.259423503325946,6.036373401763469,2367,2143,78.0,,5.0,,122,476,515,119069,4712
2020-12-26,S92000003,Scotland,1050,120119,2197.566776436151,134.22978412001464,34,4746,86.82766190998902,2534,1001971,18330.97328942554,8945,1176,13.147009502515374,6.378929740427799,3905,5040,109.0,,7.0,,230,946,1050,120119,4746
2020-12-27,S92000003,Scotland,1681,121800,2228.3205268935235,150.12806439809734,34,4780,87.44968898646178,3572,1005543,18396.322722283207,13378,1867,13.955748243384662,7.062657631650916,5066,8312,142.0,,8.0,,287,1580,1681,121800,4780
2020-12-28,S92000003,Scotland,1804,123604,2261.324551774607,159.27552140504937,31,4811,88.01683132089279,3714,1009257,18464.270032930846,20659,1990,9.632605644029235,8.041230328806114,8654,12005,155.0,,11.0,,406,1584,1804,123604,4811
2020-12-29,S92000003,Scotland,3133,126737,2318.642517380168,192.33443102817418,26,4837,88.4924990852543,5554,1014811,18565.87998536407,35114,3356,9.557441476334226,9.360212457749881,10824,24290,156.0,,12.0,,466,2890,3133,126737,4837
2020-12-30,S92000003,Scotland,2963,129700,2372.850347603366,222.52103915111599,32,4869,89.07793633369923,5879,1020690,18673.43578485181,31401,3192,10.165281360466226,10.408884165116678,9704,21697,192.0,,7.0,,451,2741,2963,129700,4869
2020-12-31,S92000003,Scotland,2374,132074,2416.2824734723745,247.3472374679839,44,4913,89.88291255031102,4878,1025568,18762.678375411637,18720,2612,13.952991452991451,11.143927008069197,6167,12553,173.0,,9.0,,409,2203,2374,132074,4913
2021-01-01,S92000003,Scotland,1159,133233,2437.4862788144897,259.12916209293815,35,4948,90.52323454079766,2054,1027622,18800.256128796198,8394,1275,15.189421015010721,11.322660693501987,3714,4680,135.0,,14.0,,228,1047,1159,133233,4948
2021-01-02,S92000003,Scotland,2211,135444,2477.9363336992315,280.3695572630809,42,4990,91.29162092938162,4306,1031928,18879.034028540063,15245,2400,15.742866513611018,11.679996641266243,4824,10421,153.0,,9.0,,328,2072,2211,135444,4990
2021-01-03,S92000003,Scotland,2218,137662,2518.514452982071,290.19392608854736,42,5032,92.0600073179656,4783,1036711,18966.53860226857,17058,2390,14.01102122171415,11.743558608645825,6116,10942,137.0,,10.0,,393,1997,2218,137662,5032
2021-01-04,S92000003,Scotland,2376,140038,2561.983168679107,300.6586169045005,37,5069,92.73691913648004,4890,1041601,19056.00073179656,24450,2644,10.813905930470348,11.882406139032595,9175,15275,187.0,,12.0,,537,2107,2376,140038,5069
2021-01-05,S92000003,Scotland,3050,143088,2617.7826564215147,299.1401390413465,40,5109,93.46871569703623,7011,1048612,19184.26637394804,37296,3420,9.16988416988417,11.754411263469756,12055,25241,196.0,,17.0,,718,2702,3050,143088,5109
2021-01-06,S92000003,Scotland,2548,145636,2664.3980973289426,291.54774972557635,48,5157,94.34687156970362,6175,1054787,19297.237467983898,30395,2899,9.537752919888142,11.639108460127476,10813,19582,201.0,,13.0,,581,2318,2548,145636,5157
2021-01-07,S92000003,Scotland,2197,147833,2704.59202341749,288.3095499451153,44,5201,95.1518477863154,5766,1060553,19402.72594218807,25211,2646,10.495418666455118,11.182607925390228,9253,15958,205.0,,18.0,,774,1872,2197,147833,5201
2021-01-08,S92000003,Scotland,1823,149656,2737.943651664837,300.4573728503476,42,5243,95.92023417489936,5200,1065753,19497.859495060373,21495,2230,10.374505698999767,10.884604148407831,8920,12575,198.0,,11.0,,582,1648,1823,149656,5243
2021-01-09,S92000003,Scotland,1497,151153,2765.331137943652,287.39480424442,38,5281,96.61544090742773,3774,1069527,19566.904500548848,13711,1752,12.778061410546277,10.601004622205453,5538,8173,183.0,,21.0,,422,1330,1497,151153,5281
2021-01-10,S92000003,Scotland,1423,152576,2791.364800585437,272.85034760336634,59,5340,97.69484083424808,3546,1073073,19631.77826564215,13424,1662,12.380810488676994,10.394500608499717,6021,7403,168.0,,15.0,,444,1218,1423,152576,5340
2021-01-11,S92000003,Scotland,2087,154663,2829.546286132455,267.563117453348,48,5388,98.57299670691549,5737,1078810,19736.73618733992,29253,2381,8.139336136464637,9.948180460813305,12145,17108,241.0,,9.0,,606,1775,2087,154663,5388
2021-01-12,S92000003,Scotland,1977,156640,2865.715331137944,247.93267471642883,51,5439,99.5060373216246,4733,1083543,19823.326015367733,31065,2410,7.757926927410269,9.711097876684855,12951,18114,211.0,,16.0,,756,1654,1977,156640,5439
2021-01-13,S92000003,Scotland,1712,158352,2897.0362239297474,232.6381266008049,51,5490,100.43907793633369,4529,1088072,19906.183680936698,25123,2097,8.34693308920113,9.529011438831759,10533,14590,180.0,,16.0,,625,1472,1712,158352,5490
2021-01-14,S92000003,Scotland,1620,159972,2926.6739846322725,222.0819612147823,58,5548,101.50018294914013,4022,1092094,19979.765825100625,20739,1996,9.624379188967644,9.384406692074156,8608,12131,204.0,,19.0,,530,1466,1620,159972,5548
2021-01-15,S92000003,Scotland,1535,161507,2954.756677643615,216.81302597877792,58,5606,102.56128796194658,4444,1096538,20061.068422978413,20018,1820,9.091817364372066,9.207411320459393,9322,10696,184.0,,13.0,,472,1348,1535,161507,5606
2021-01-16,S92000003,Scotland,1176,162683,2976.271496523966,210.94035858031467,76,5682,103.95170142700329,3121,1099659,20118.1668496158,12466,1392,11.16637253329055,9.046078586081745,5858,6608,170.0,,17.0,,347,1045,1176,162683,5682
2021-01-17,S92000003,Scotland,1199,163882,2998.207098426637,206.84229784120015,43,5725,104.73838272960116,2740,1102399,20168.294914013903,11206,1446,12.903801534892025,9.03583105357977,5540,5666,160.0,,15.0,,410,1036,1199,163882,5725
2021-01-18,S92000003,Scotland,1735,165617,3029.948774240761,200.4024881083059,63,5788,105.89096231247714,5110,1107509,20261.78192462496,28889,2064,7.144587905431132,8.845798830816154,14622,14267,175.0,,19.0,,557,1507,1735,165617,5788
2021-01-19,S92000003,Scotland,1548,167165,3058.2693011342853,192.553969996341,70,5858,107.17160629345041,4858,1112367,20350.6586169045,30016,1831,6.100079957356077,8.518291491812443,14564,15452,197.0,,15.0,,517,1314,1548,167165,5858
2021-01-20,S92000003,Scotland,1572,168737,3087.028905964142,189.99268203439445,66,5924,108.37907061836809,4263,1116630,20428.649835345776,24796,1876,7.565736409098243,8.387902518058464,12386,12410,184.0,,17.0,,565,1311,1572,168737,5924
2021-01-21,S92000003,Scotland,1240,169977,3109.714599341383,183.04061470911088,57,5981,109.42188071716065,4238,1120868,20506.183680936698,21364,1598,7.479872683018161,8.085106382978722,10055,11309,194.0,,17.0,,538,1060,1240,169977,5981
2021-01-22,S92000003,Scotland,1228,171205,3132.1807537504574,177.4240761068423,68,6049,110.66593487010613,3999,1124867,20579.345042078305,18943,1470,7.760122472681202,7.906960996749729,9975,8968,171.0,,8.0,,434,1036,1228,171205,6049
2021-01-23,S92000003,Scotland,936,172141,3149.3047932674717,173.03329674350533,53,6102,111.63556531284306,3298,1128165,20639.68166849616,11624,1109,9.540605643496216,7.759571772974298,5070,6554,147.0,,7.0,,305,804,936,172141,6102
2021-01-24,S92000003,Scotland,857,172998,3164.9835345773877,166.7764361507501,70,6172,112.91620929381632,2863,1131028,20692.06000731797,10712,984,9.185959671396564,7.470070518777675,5176,5536,119.0,,9.0,,253,731,857,172998,6172
2021-01-25,S92000003,Scotland,1318,174316,3189.096231247713,159.1474570069521,52,6224,113.86754482253932,4769,1135797,20779.30845225028,26507,1599,6.032368808239332,7.270668648671178,15050,11457,147.0,,14.0,,502,1097,1318,174316,6224
2021-01-26,S92000003,Scotland,1178,175494,3210.647639956092,152.37833882180755,50,6274,114.78229052323454,4007,1139804,20852.616172703987,27252,1418,5.203287832085718,7.1204974574710675,15829,11423,161.0,,6.0,,403,1015,1178,175494,6274
2021-01-27,S92000003,Scotland,1112,176606,3230.9915843395534,143.96267837541163,61,6335,115.8982802780827,4144,1143948,20928.430296377606,22619,1314,5.809275387948184,6.827745448529358,12422,10197,156.0,,13.0,,344,970,1112,176606,6335
2021-01-28,S92000003,Scotland,1113,177719,3251.3538236370287,141.63922429564582,46,6381,116.73984632272229,4357,1148305,21008.141236736188,21072,1310,6.216780561883067,6.634517656726423,10329,10743,140.0,,8.0,,400,910,1113,177719,6381
2021-01-29,S92000003,Scotland,961,178680,3268.935236004391,136.75448225393342,59,6440,117.81924624954263,3838,1152143,21078.357116721552,17483,1159,6.629297031401932,6.478520277702904,9237,8246,152.0,,12.0,,324,835,961,178680,6440
2021-01-30,S92000003,Scotland,779,179459,3283.186974021222,133.88218075375045,44,6484,118.62422246615441,2739,1154882,21128.46688620564,10537,931,8.835531935085887,6.399524166189366,4880,5657,118.0,,9.0,,221,710,779,179459,6484
2021-01-31,S92000003,Scotland,809,180268,3297.9875594584705,133.00402488108307,48,6532,119.5023783388218,2364,1157246,21171.716062934505,9806,966,9.851111564348358,6.429078328750111,5019,4787,108.0,,12.0,,240,726,809,180268,6532
2021-02-01,S92000003,Scotland,1095,181363,3318.020490303696,128.92425905598245,43,6575,120.2890596414197,4076,1161322,21246.286132455174,24555,1302,5.302382406841784,6.300441030872161,15672,8883,123.0,,9.0,,325,977,1095,181363,6575
2021-02-02,S92000003,Scotland,1049,182412,3337.211855104281,126.56421514818881,44,6619,121.09403585803149,3901,1165223,21317.654592023417,27108,1246,4.5964290984211305,6.178104820543625,17207,9901,112.0,,11.0,,348,898,1049,182412,6619
2021-02-03,S92000003,Scotland,930,183342,3354.226125137212,123.23454079765823,48,6667,121.97219173069887,3574,1168797,21383.040614709116,21780,1107,5.082644628099174,6.0608579351825975,13180,8600,111.0,,5.0,,281,826,930,183342,6667
2021-02-04,S92000003,Scotland,899,184241,3370.6732528357124,119.31942919868277,32,6699,122.55762897914379,3671,1172468,21450.201244054155,20882,1073,5.138396705296428,5.8902316289698895,11210,9672,111.0,,7.0,,273,800,899,184241,6699
2021-02-05,S92000003,Scotland,935,185176,3387.778997438712,118.8437614343213,44,6743,123.36260519575556,3524,1175992,21514.672521039152,17944,1081,6.024297815425769,5.810937170090188,9918,8026,114.0,,14.0,,291,790,935,185176,6743
2021-02-06,S92000003,Scotland,698,185874,3400.5488474204167,117.36187339919505,51,6794,124.29564581046469,2441,1178433,21559.330406147088,9856,805,8.167613636363637,5.7454275340897905,4878,4978,92.0,,7.0,,154,651,698,185874,6794
2021-02-07,S92000003,Scotland,654,186528,3412.5137211855103,114.52616172703988,42,6836,125.0640321990487,2200,1180633,21599.57921697768,9200,780,8.478260869565217,5.630306491528652,4908,4292,96.0,,10.0,,208,572,654,186528,6836
2021-02-08,S92000003,Scotland,991,187519,3430.643980973289,112.62349066959385,40,6876,125.79582875960483,3550,1184183,21664.52616172704,23519,1155,4.910923083464434,5.5622500748336385,15665,7854,83.0,,15.0,,315,840,991,187519,6876
2021-02-09,S92000003,Scotland,758,188277,3444.5115257958287,107.29967069154776,49,6925,126.69227954628613,2734,1186917,21714.54445664105,21985,888,4.039117580168297,5.503890832973812,15756,6229,97.0,,9.0,,300,588,758,188277,6925
2021-02-10,S92000003,Scotland,845,189122,3459.9707281375777,105.7446030003659,37,6962,127.36919136480057,2759,1189676,21765.02012440541,18369,1006,5.476618215471718,5.575130384789126,11929,6440,81.0,,7.0,,326,680,845,189122,6962
2021-02-11,S92000003,Scotland,842,189964,3475.3750457372853,104.70179290157336,35,6997,128.00951335528723,3340,1193016,21826.125137211853,20219,1015,5.0200306642267165,5.557757737918277,11116,9103,95.0,,12.0,,331,684,842,189964,6997
2021-02-12,S92000003,Scotland,902,190866,3491.877058177827,104.09806073911452,41,7038,128.7596048298573,3504,1196520,21890.230515916577,17615,1027,5.830258302583027,5.528183301176685,9403,8212,94.0,,12.0,,283,744,902,190866,7038
2021-02-13,S92000003,Scotland,542,191408,3501.7929015733625,101.24405415294548,32,7070,129.34504207830224,2422,1198942,21934.54079765825,9783,641,6.552182357150159,5.395641726737924,4785,4998,71.0,,7.0,,154,487,542,191408,7070
2021-02-14,S92000003,Scotland,681,192089,3514.251738016831,101.73801683132088,32,7102,129.93047932674716,2164,1201106,21974.13099158434,9258,775,8.371138474832577,5.388909133070527,4927,4331,64.0,,9.0,,173,602,681,192089,7102
2021-02-15,S92000003,Scotland,963,193052,3531.869740212221,101.22575923893156,34,7136,130.55250640321992,3682,1204788,22041.49286498353,24548,1102,4.489164086687307,5.299851367663845,16652,7896,91.0,,13.0,,273,829,963,193052,7136
2021-02-16,S92000003,Scotland,912,193964,3548.554701792902,104.0431759970728,26,7162,131.0281741675814,3584,1208372,22107.06183680937,25697,1055,4.105537611394326,5.2761596633967915,18127,7570,98.0,,8.0,,231,824,912,193964,7162
2021-02-17,S92000003,Scotland,825,194789,3563.6480058543725,103.67727771679472,28,7190,131.54043175997072,3339,1211711,22168.1485547018,20833,978,4.694475111601785,5.152673247207959,13726,7107,75.0,,8.0,,216,762,825,194789,7190
2021-02-18,S92000003,Scotland,879,195668,3579.729235272594,104.3541895353092,35,7225,132.18075375045737,4008,1215719,22241.474570069517,23216,1012,4.359062715368712,5.032455135547918,12021,11195,77.0,,9.0,,217,795,879,195668,7225
2021-02-19,S92000003,Scotland,890,196558,3596.0117087449685,104.13465056714236,44,7269,132.98572996706915,4076,1219795,22316.044639590196,19494,1027,5.268287678259976,4.961265988601887,9536,9958,91.0,,12.0,,188,839,890,196558,7269
2021-02-20,S92000003,Scotland,660,197218,3608.0863519941454,106.29345042078302,27,7296,133.47969264544454,2908,1222703,22369.246249542623,11480,766,6.672473867595817,4.991600136776534,5085,6395,86.0,,3.0,,136,630,660,197218,7296
2021-02-21,S92000003,Scotland,609,197827,3619.227954628613,104.97621661178192,20,7316,133.84559092572266,2447,1225150,22414.01390413465,9866,705,7.145753091425097,4.917341305666968,4677,5189,70.0,,10.0,,142,563,609,197827,7316
2021-02-22,S92000003,Scotland,787,198614,3633.6260519575562,101.7563117453348,22,7338,134.24807903402854,4332,1229482,22493.267471642885,24945,946,3.7923431549408706,4.787834517564248,16795,8150,73.0,,9.0,,204,742,787,198614,7338
2021-02-23,S92000003,Scotland,693,199307,3646.3044273691917,97.7497255762898,16,7354,134.540797658251,3708,1233190,22561.10501280644,25696,809,3.1483499377335,4.6063602154504535,18380,7316,66.0,,6.0,,172,637,693,199307,7354
2021-02-24,S92000003,Scotland,699,200006,3659.0925722649104,95.44456641053787,18,7372,134.8701061105013,3420,1236610,22623.673618733996,21100,796,3.772511848341232,4.46327974844805,14005,7095,57.0,,5.0,,142,654,699,200006,7372
2021-02-25,S92000003,Scotland,628,200634,3670.5817782656413,90.85254299304792,20,7392,135.23600439077936,3683,1240293,22691.053787047204,22163,719,3.2441456481523265,4.2807100872766135,11056,11107,49.0,,3.0,,122,597,628,200634,7392
2021-02-26,S92000003,Scotland,514,201148,3679.985364068789,83.97365532381998,16,7408,135.52872301500184,3445,1243738,22754.0797658251,17832,604,3.38716913414087,4.016320764641349,8935,8897,62.0,,6.0,,112,492,514,201148,7408
2021-02-27,S92000003,Scotland,414,201562,3687.5594584705455,79.47310647639956,19,7427,135.876326381266,2518,1246256,22800.146359312108,10199,503,4.931856064320032,3.8558129300991646,4528,5671,50.0,,4.0,,94,409,414,201562,7427
2021-02-28,S92000003,Scotland,426,201988,3695.3530918404686,76.12513721185509,9,7436,136.04098060739113,2199,1248455,22840.37687522868,9387,489,5.2093320549696385,3.705395897107872,4733,4654,53.0,,3.0,,68,421,426,201988,7436
2021-03-01,S92000003,Scotland,547,202535,3705.3604098060737,71.73435784851813,20,7456,136.40687888766922,3973,1252428,22913.062568605932,23843,663,2.780690349368788,3.5194286591921364,16526,7317,66.0,,7.0,,156,507,547,202535,7456
2021-03-02,S92000003,Scotland,518,203053,3714.837175265277,68.53274789608489,12,7468,136.62641785583608,3580,1256008,22978.558360775707,25455,610,2.396385778825378,3.3728525377176317,18970,6485,64.0,,4.0,,114,496,518,203053,7468
2021-03-03,S92000003,Scotland,495,203548,3723.893157702159,64.80058543724844,11,7479,136.82766190998902,3211,1259219,23037.30332967435,20016,596,2.97761790567546,3.2460529888669067,13868,6148,40.0,,9.0,,116,480,495,203548,7479
2021-03-04,S92000003,Scotland,558,204106,3734.1017197219176,63.519941456275156,14,7493,137.0837907061837,3380,1262599,23099.14013904134,22368,657,2.9372317596566524,3.1928737412858252,11256,11112,45.0,,0.0,,106,551,558,204106,7493
2021-03-05,S92000003,Scotland,465,204571,3742.6088547383833,62.62349066959385,8,7501,137.23015001829492,3556,1266155,23164.19685327479,18562,547,2.9468807240599078,3.1310174844026806,8799,9763,39.0,,3.0,,101,446,465,204571,7501
2021-03-06,S92000003,Scotland,480,205051,3751.3904134650566,63.83095499451153,10,7511,137.41309915843394,2568,1268723,23211.178192462496,11024,558,5.061683599419449,3.1533427729516665,4639,6385,36.0,,5.0,,76,482,480,205051,7511
2021-03-07,S92000003,Scotland,433,205484,3759.312111233077,63.95901939260885,10,7521,137.596048298573,2463,1271186,23256.23856567874,10460,497,4.7514340344168255,3.13373011053079,4999,5461,24.0,,4.0,,74,423,433,205484,7521
2021-03-08,S92000003,Scotland,588,206072,3770.069520673253,64.70911086717892,15,7536,137.87047200878158,4425,1275611,23337.193560190262,25490,672,2.6363279717536288,3.1017806935332715,17067,8423,34.0,,2.0,,123,549,588,206072,7536
2021-03-09,S92000003,Scotland,653,206725,3782.0160995243323,67.17892425905599,10,7546,138.0534211489206,4040,1279651,23411.10501280644,26183,741,2.8300805866401864,3.1826282782637225,18479,7704,45.0,,4.0,,103,638,653,206725,7546
2021-03-10,S92000003,Scotland,622,207347,3793.395536040981,69.5023783388218,5,7551,138.14489571899014,3755,1283406,23479.802414928654,21627,698,3.227447172515837,3.22000677896164,13936,7691,34.0,,2.0,,97,601,622,207347,7551
2021-03-11,S92000003,Scotland,662,208009,3805.506769118185,71.40504939626784,8,7559,138.29125503110137,3641,1287047,23546.414196853275,24113,740,3.0688840044789125,3.23951141795008,11811,12302,34.0,,3.0,,115,625,662,208009,7559
2021-03-12,S92000003,Scotland,584,208593,3816.190998902305,73.58214416392244,6,7565,138.40102451518482,3918,1290965,23618.09366995975,21088,654,3.1012898330804246,3.257491874129371,9271,11817,41.0,,2.0,,80,574,584,208593,7565
2021-03-13,S92000003,Scotland,464,209057,3824.679839004757,73.28942553969995,4,7569,138.47420417124042,2611,1293576,23665.861690450052,11672,538,4.609321453050034,3.2282607922749285,4774,6898,28.0,,4.0,,75,463,464,209057,7569
2021-03-14,S92000003,Scotland,443,209500,3832.784485912917,73.472374679839,7,7576,138.60226856933772,2440,1296016,23710.50128064398,10259,504,4.912759528219126,3.2378660134442288,4662,5597,26.0,,4.0,,64,440,443,209500,7576
2021-03-15,S92000003,Scotland,688,210188,3845.3713867544816,75.30186608122942,1,7577,138.62056348335162,4473,1300489,23792.334431028175,26180,756,2.8877005347593583,3.2815578010515725,17338,8842,40.0,,4.0,,106,650,688,210188,7577
2021-03-16,S92000003,Scotland,572,210760,3855.836077570436,73.81997804610319,11,7588,138.82180753750458,4122,1304611,23867.746066593492,27225,637,2.3397612488521577,3.1843504684730317,19666,7559,25.0,,2.0,,88,549,572,210760,7588
2021-03-17,S92000003,Scotland,597,211357,3866.758141236736,73.36260519575558,8,7596,138.9681668496158,3626,1308237,23934.083424807905,21705,683,3.1467403824003686,3.1720588855612273,14299,7406,36.0,,5.0,,93,590,597,211357,7596
2021-03-18,S92000003,Scotland,552,211909,3876.856933772412,71.35016465422612,3,7599,139.02305159165752,3683,1311920,24001.463593121112,24030,618,2.571785268414482,3.0880915031760217,11759,12271,32.0,,0.0,,76,542,552,211909,7599
2021-03-19,S92000003,Scotland,542,212451,3886.772777167947,70.58177826564216,6,7605,139.13282107574094,4147,1316067,24077.332601536767,21978,603,2.7436527436527443,3.0332263769757213,9713,12265,23.0,,2.0,,71,532,542,212451,7605
2021-03-20,S92000003,Scotland,458,212909,3895.151847786316,70.47200878155873,5,7610,139.22429564581046,2748,1318815,24127.607025246984,12041,512,4.25213852670044,3.007293366244125,4754,7287,19.0,,3.0,,44,468,458,212909,7610
2021-03-21,S92000003,Scotland,463,213372,3903.622392974753,70.83790706183682,4,7614,139.2974753018661,2483,1321298,24173.033296743506,10987,500,4.55083280240284,2.989330262372872,4966,6021,29.0,,2.0,,65,435,463,213372,7614
2021-03-22,S92000003,Scotland,680,214052,3916.062934504208,70.69154774972556,3,7617,139.3523600439078,5208,1326506,24268.31320892792,28230,753,2.6673751328374067,2.9453610221893896,17205,11025,32.0,,1.0,,85,668,680,214052,7617
2021-03-23,S92000003,Scotland,603,214655,3927.0947676545925,71.25869008415658,3,7620,139.4072447859495,5108,1331614,24361.763629710942,29221,671,2.2962937613360253,2.92863312459512,19195,10026,28.0,,4.0,,61,610,603,214655,7620
2021-03-24,S92000003,Scotland,541,215196,3936.992316136114,70.23417489937798,4,7624,139.48042444200513,4262,1335876,24439.7365532382,23533,599,2.545361832320571,2.8369550726569783,14363,9170,27.0,,3.0,,65,534,541,215196,7624
2021-03-25,S92000003,Scotland,573,215769,3947.475301866081,70.61836809366994,7,7631,139.6084888401025,4097,1339973,24514.69081595317,25768,645,2.50310462589258,2.8222564873021523,11914,13854,29.0,,4.0,,61,584,573,215769,7631
2021-03-26,S92000003,Scotland,474,216243,3956.1470911086717,69.37431394072448,5,7636,139.69996341017202,3942,1343915,24586.809366995978,22276,525,2.3567965523433294,2.765428526332404,9884,12392,24.0,,3.0,,58,467,474,216243,7636
2021-03-27,S92000003,Scotland,386,216629,3963.208927918039,68.05708013172338,5,7641,139.79143798024148,2753,1346668,24637.17526527625,12223,424,3.468870162807821,2.7043182385475375,4921,7302,20.0,,2.0,,31,393,386,216629,7641
2021-03-28,S92000003,Scotland,357,216986,3969.740212221003,66.11781924624954,5,7646,139.882912550311,2894,1349562,24690.12074643249,12554,406,3.234028994742712,2.615649686291083,5819,6735,24.0,,4.0,,37,369,357,216986,7646
2021-03-29,S92000003,Scotland,514,217500,3979.143798024149,63.08086351994147,5,7651,139.97438712038056,5342,1354904,24787.85217709477,29314,569,1.941052057037593,2.478549154555844,18608,10706,22.0,,2.0,,58,511,514,217500,7651
2021-03-30,S92000003,Scotland,394,217894,3986.351994145628,59.25722649103549,2,7653,140.01097694840834,4520,1359424,24870.545188437616,26991,449,1.6635174687858916,2.3693329577686217,18305,8686,20.0,,2.0,,56,393,394,217894,7653
2021-03-31,S92000003,Scotland,394,218288,3993.5601902671056,56.567874130991584,1,7654,140.02927186242223,3781,1363205,24939.71825832419,22337,462,2.0683171419617667,2.297590830763949,14545,7792,21.0,,2.0,,58,404,394,218288,7654
2021-04-01,S92000003,Scotland,413,218701,4001.115989754849,53.64068788876693,1,7655,140.04756677643616,3365,1366570,25001.28064398097,23868,463,1.939835763365175,2.2050908312884867,11925,11943,23.0,,3.0,,52,411,413,218701,7655
2021-04-02,S92000003,Scotland,353,219054,4007.574094401757,51.42700329308454,2,7657,140.08415660446397,2787,1369357,25052.268569337728,16670,397,2.3815236952609475,2.2020464444243766,7173,9497,26.0,,1.0,,41,356,353,219054,7657
2021-04-03,S92000003,Scotland,280,219334,4012.6966703256494,49.48774240761068,2,7659,140.12074643249179,2391,1371748,25096.01170874497,11323,319,2.817274573876181,2.1425026388083066,5195,6128,17.0,,1.0,,36,283,280,219334,7659
2021-04-04,S92000003,Scotland,254,219588,4017.3435784851813,47.60336626417856,1,7660,140.13904134650568,2208,1373956,25136.406878887672,11354,294,2.589395807644882,2.0816737982616296,6596,4758,15.0,,0.0,,33,261,254,219588,7660
2021-04-05,S92000003,Scotland,293,219881,4022.703988291255,43.56019026710575,4,7664,140.21222100256128,2970,1376926,25190.74277350896,20356,335,1.645706425623895,2.045914566701029,14487,5869,32.0,,2.0,,39,296,293,219881,7664
2021-04-06,S92000003,Scotland,356,220237,4029.216977680205,42.86498353457738,2,7666,140.2488108305891,3941,1380867,25262.84302963776,25299,392,1.5494683584331397,2.028855167788304,17677,7622,21.0,,2.0,,37,355,356,220237,7666
2021-04-07,S92000003,Scotland,282,220519,4034.376143432126,40.81595316502013,2,7668,140.2854006586169,3188,1384055,25321.16721551408,22214,325,1.4630413252903576,1.9262457660736625,15663,6551,21.0,,2.0,,35,290,282,220519,7668
2021-04-08,S92000003,Scotland,282,220801,4039.535309184047,38.41931942919868,2,7670,140.32199048664472,2922,1386977,25374.62495426272,23011,337,1.4645169701447134,1.84216790680888,12076,10935,22.0,,0.0,,40,297,282,220801,7670
2021-04-09,S92000003,Scotland,266,221067,4044.4017563117454,36.82766190998903,2,7672,140.35858031467254,3008,1389985,25429.656055616542,19469,302,1.5511839334326365,1.7319922421180818,9568,9901,20.0,,0.0,,47,255,266,221067,7672
2021-04-10,S92000003,Scotland,227,221294,4048.5547017929016,35.858031467252104,3,7675,140.41346505671422,2233,1392218,25470.50859860959,10273,265,2.579577533339823,1.7048554282596835,4877,5396,15.0,,1.0,,42,223,227,221294,7675
2021-04-11,S92000003,Scotland,212,221506,4052.433223563849,35.08964507866813,2,7677,140.45005488474206,2144,1394362,25509.7328942554,10044,244,2.4293110314615687,1.6836820596023447,5433,4611,13.0,,1.0,,27,217,212,221506,7677
2021-04-12,S92000003,Scotland,260,221766,4057.189901207464,34.48591291620929,0,7677,140.45005488474206,3580,1397942,25575.22868642517,23934,307,1.2826940753739449,1.617949405560025,17724,6210,15.0,,1.0,,35,272,260,221766,7677
2021-04-13,S92000003,Scotland,261,222027,4061.964873765093,32.747896084888396,0,7677,140.45005488474206,3280,1401222,25635.236004390776,23988,298,1.2422878105719526,1.563193488449068,18737,5251,12.0,,2.0,,46,252,261,222027,7677
2021-04-14,S92000003,Scotland,212,222239,4065.843395536041,31.46725210391511,3,7680,140.50493962678377,2759,1403981,25685.711672155143,19990,244,1.2206103051525763,1.5278213435953147,14811,5179,17.0,,2.0,,26,218,212,222239,7680
2021-04-15,S92000003,Scotland,198,222437,4069.465788510794,29.930479326747164,2,7682,140.54152945481155,2678,1406659,25734.705451884376,20883,241,1.15404874778528,1.4784454935021505,11738,9145,15.0,,0.0,,39,202,198,222437,7682
2021-04-16,S92000003,Scotland,382,222819,4076.454445664105,32.052689352360055,1,7683,140.55982436882545,2495,1409154,25780.351262349068,18006,633,3.515494835054981,1.7558488963010743,9111,8895,14.0,,1.0,,30,603,382,222819,7683
2021-04-17,S92000003,Scotland,202,223021,4080.150018294914,31.595316502012444,1,7684,140.57811928283937,1847,1411001,25814.14196853275,9551,228,2.3871845880012565,1.7366055887844554,4604,4947,10.0,,2.0,,27,201,202,223021,7684
2021-04-18,S92000003,Scotland,178,223199,4083.406512989389,30.973289425539697,0,7684,140.57811928283937,1974,1412975,25850.256128796198,10190,215,2.1099116781158,1.711684658058194,5960,4230,13.0,,0.0,,24,191,178,223199,7684
2021-04-19,S92000003,Scotland,264,223463,4088.2363702890602,31.046469081595315,1,7685,140.5964141968533,3470,1416445,25913.739480424443,24469,301,1.2301279169561483,1.6997568403408956,18435,6034,15.0,,2.0,,39,262,264,223463,7685
2021-04-20,S92000003,Scotland,242,223705,4092.6637394804247,30.698865715331134,1,7686,140.61470911086718,3290,1419735,25973.92974753019,24253,261,1.0761555271512802,1.6671640150146847,19079,5174,13.0,,0.0,,35,226,242,223705,7686
2021-04-21,S92000003,Scotland,237,223942,4096.99963410172,31.15623856567874,3,7689,140.6695938529089,2791,1422526,26024.990852542996,19331,265,1.3708551032021106,1.6924133467000306,14137,5194,13.0,,1.0,,38,227,237,223942,7689
2021-04-22,S92000003,Scotland,231,224173,4101.2257592389315,31.759970728137574,0,7689,140.6695938529089,2693,1425219,26074.259055982435,21069,271,1.2862499406711283,1.7135785731739035,11559,9510,12.0,,1.0,,38,233,231,224173,7689
2021-04-23,S92000003,Scotland,188,224361,4104.665203073546,28.210757409440173,2,7691,140.7061836809367,2782,1428001,26125.155506769115,18238,214,1.1733742734949009,1.3807916538815588,9523,8715,12.0,,1.0,,27,187,188,224361,7691
2021-04-24,S92000003,Scotland,150,224511,4107.409440175631,27.259421880717163,0,7691,140.7061836809367,2013,1430014,26161.983168679108,9773,173,1.7701831576793206,1.3351868868939627,4894,4879,9.0,,2.0,,23,150,150,224511,7691
2021-04-25,S92000003,Scotland,109,224620,4109.403585803147,25.997072813757768,2,7693,140.74277350896455,1925,1431939,26197.200878155872,10108,127,1.2564305500593589,1.266887245463333,6252,3856,9.0,,0.0,,14,113,109,224620,7693
2021-04-26,S92000003,Scotland,195,224815,4112.971094035858,24.73472374679839,2,7695,140.77936333699233,3677,1435616,26264.471276985,25421,217,0.85362495574525,1.1919527587309757,19270,6151,13.0,,1.0,,26,191,195,224815,7695
2021-04-27,S92000003,Scotland,195,225010,4116.538602268569,23.87486278814489,1,7696,140.79765825100625,3579,1439195,26329.948774240762,24308,226,0.929735066644726,1.1641507080032438,18654,5654,12.0,,2.0,,34,192,195,225010,7696
2021-04-28,S92000003,Scotland,193,225203,4120.0695206732535,23.06988657153311,1,7697,140.81595316502012,2759,1441954,26380.42444200512,19692,217,1.101970343286614,1.1235605595253833,14499,5193,9.0,,0.0,,43,174,193,225203,7697
2021-04-29,S92000003,Scotland,174,225377,4123.252835711673,22.02707647274058,0,7697,140.81595316502012,2575,1444529,26427.533845590933,20734,199,0.9597762129835054,1.0703649999220421,11605,9129,9.0,,0.0,,24,175,174,225377,7697
2021-04-30,S92000003,Scotland,172,225549,4126.399560922064,21.734357848518115,0,7697,140.81595316502012,2645,1447174,26475.923893157706,17120,197,1.1507009345794392,1.0664066186416683,8364,8756,9.0,,3.0,,24,173,172,225549,7697
2021-05-01,S92000003,Scotland,126,225675,4128.704720087815,21.295279912184405,0,7697,140.81595316502012,2052,1449226,26513.465056714238,9463,145,1.5322836309838317,1.0469388076880626,4648,4815,8.0,,1.0,,10,135,126,225675,7697
2021-05-02,S92000003,Scotland,121,225796,4130.918404683498,21.51481888035126,1,7698,140.834248079034,1916,1451142,26548.518111964877,9908,135,1.3625353249899073,1.0549089588301248,6078,3830,7.0,,1.0,,14,121,121,225796,7698
2021-05-03,S92000003,Scotland,162,225958,4133.8821807537515,20.911086717892424,0,7698,140.834248079034,3107,1454249,26605.360409806068,21235,174,0.8194019307746645,1.0558549730524254,16342,4893,6.0,,2.0,,15,159,162,225958,7698
2021-05-04,S92000003,Scotland,196,226154,4137.467983900476,20.929381631906327,0,7698,140.834248079034,3861,1458110,26675.99707281376,26391,213,0.8070933272706604,1.0277574813518222,19730,6661,11.0,,2.0,,19,194,196,226154,7698
2021-05-05,S92000003,Scotland,222,226376,4141.529454811562,21.45993413830955,0,7698,140.834248079034,3087,1461197,26732.473472374684,20649,245,1.18649813550293,1.0422310756972113,14668,5981,9.0,,0.0,,33,212,222,226376,7698
2021-05-06,S92000003,Scotland,218,226594,4145.517746066593,22.264910354921327,0,7698,140.834248079034,2752,1463949,26782.821075740943,21320,242,1.1350844277673546,1.0714908871722475,11806,9514,18.0,,2.0,,25,217,218,226594,7698
2021-05-07,S92000003,Scotland,203,226797,4149.231613611416,22.832052689352366,0,7698,140.834248079034,3042,1466991,26838.47420417124,18877,226,1.1972241351909731,1.0794490116783868,9758,9119,12.0,,1.0,,19,207,203,226797,7698
2021-05-08,S92000003,Scotland,185,226982,4152.616172703989,23.911452616172706,0,7698,140.834248079034,2351,1469342,26881.48554701793,10196,200,1.9615535504119264,1.1160714285714286,4919,5277,11.0,,1.0,,19,181,185,226982,7698
2021-05-09,S92000003,Scotland,210,227192,4156.458104646908,25.539699963410172,0,7698,140.834248079034,2326,1471668,26924.03951701427,11022,226,2.050444565414625,1.176652016346673,6194,4828,12.0,,0.0,,18,208,210,227192,7698
2021-05-10,S92000003,Scotland,329,227521,4162.477131357482,28.594950603732162,0,7698,140.834248079034,4372,1476040,27004.02488108306,26438,361,1.3654588092896593,1.269895398575167,18620,7818,7.0,,3.0,,27,334,329,227521,7698
2021-05-11,S92000003,Scotland,283,227804,4167.6545920234175,30.186608122941823,0,7698,140.834248079034,4030,1480070,27077.75338455909,26398,316,1.1970603833623759,1.346182357301705,19663,6735,19.0,,1.0,,27,289,283,227804,7698
2021-05-12,S92000003,Scotland,298,228102,4173.106476399561,31.577021587998534,2,7700,140.87083790706185,3505,1483575,27141.877058177823,21132,322,1.5237554419837214,1.3982553200918877,14401,6731,11.0,,0.0,,31,291,298,228102,7700
2021-05-13,S92000003,Scotland,314,228416,4178.851079399927,33.333333333333336,0,7700,140.87083790706185,3082,1486657,27198.261983168682,21996,332,1.5093653391525732,1.4574559566070602,11778,10218,15.0,,0.0,,48,284,314,228416,7700
2021-05-14,S92000003,Scotland,291,228707,4184.174899377973,34.9432857665569,0,7700,140.87083790706185,3575,1490232,27263.666300768386,19968,314,1.5725160256410255,1.5100255195041925,9647,10321,9.0,,0.0,,14,300,291,228707,7700
2021-05-15,S92000003,Scotland,228,228935,4188.346139773143,35.729967069154775,0,7700,140.87083790706185,2866,1493098,27316.09952433224,11338,247,2.178514729229141,1.531541954704538,4944,6394,6.0,,0.0,,18,229,228,228935,7700
2021-05-16,S92000003,Scotland,231,229166,4192.5722649103545,36.11416026344676,0,7700,140.87083790706185,2548,1495646,27362.714965239662,12141,246,2.026192241166296,1.5335949100142745,6584,5557,11.0,,1.0,,21,225,231,229166,7700
2021-05-17,S92000003,Scotland,361,229527,4199.176728869375,36.699597511891696,1,7701,140.88913282107575,5308,1500954,27459.824368825462,29171,401,1.3746529087107058,1.5322489869428186,19121,10050,12.0,,1.0,,24,377,361,229527,7701
2021-05-18,S92000003,Scotland,417,229944,4206.805708013173,39.15111598975486,0,7701,140.88913282107575,4608,1505562,27544.12733260154,28079,448,1.5954984151857257,1.6061185468451242,19639,8440,20.0,,0.0,,47,401,417,229944,7701
2021-05-19,S92000003,Scotland,409,230353,4214.288327844859,41.18185144529821,0,7701,140.88913282107575,4333,1509895,27623.399195023783,23257,447,1.9220019778991275,1.6683795820486471,14727,8530,19.0,,1.0,,31,416,409,230353,7701
2021-05-20,S92000003,Scotland,381,230734,4221.258690084156,42.40761068422978,0,7701,140.88913282107575,4190,1514085,27700.054884742047,25122,417,1.659899689515166,1.6904129437333983,11922,13200,21.0,,1.0,,42,375,381,230734,7701
2021-05-21,S92000003,Scotland,360,231094,4227.8448591291635,43.669959751189175,0,7701,140.88913282107575,4398,1518483,27780.515916575194,22097,400,1.8102004797031277,1.7234879798948448,9736,12361,25.0,,3.0,,22,378,360,231094,7701
2021-05-22,S92000003,Scotland,291,231385,4233.168679107208,44.822539334065134,1,7702,140.9074277350896,3123,1521606,27837.65093304061,12203,319,2.6141112841104643,1.7610311040967976,4997,7206,21.0,,1.0,,29,290,291,231385,7702
2021-05-23,S92000003,Scotland,324,231709,4239.096231247713,46.52396633735821,1,7703,140.92572264910353,2807,1524413,27889.00475667764,12899,359,2.783161485386464,1.8262360300468496,6590,6309,16.0,,0.0,,25,334,324,231709,7703
2021-05-24,S92000003,Scotland,496,232205,4248.1705085986105,48.99377972923528,0,7703,140.92572264910353,5317,1529730,27986.27881448957,29159,531,1.8210501045989231,1.9114490629253482,18519,10640,21.0,,1.0,,34,497,496,232205,7703
2021-05-25,S92000003,Scotland,504,232709,4257.3911452616185,50.585437248444926,0,7703,140.92572264910353,5095,1534825,28079.491401390416,29658,564,1.9016791422213233,1.967032611159688,19953,9705,22.0,,1.0,,46,518,504,232709,7703
2021-05-26,S92000003,Scotland,627,233336,4268.862056348336,54.573728503476026,1,7704,140.94401756311746,4419,1539244,28160.33662641785,24416,665,2.7236238532110093,2.0925209252092523,14812,9604,15.0,,1.0,,29,636,627,233336,7704
2021-05-27,S92000003,Scotland,552,233888,4278.96084888401,57.70215879985364,1,7705,140.96231247713138,4161,1543405,28236.46176362971,24876,588,2.363724071394115,2.205939166044248,11738,13138,18.0,,1.0,,33,555,552,233888,7705
2021-05-28,S92000003,Scotland,549,234437,4289.004756677644,61.159897548481524,1,7706,140.9806073911453,4064,1547469,28310.81229418222,21313,593,2.7823394172570737,2.3420310113639307,9309,12004,28.0,,1.0,,30,563,549,234437,7706
2021-05-29,S92000003,Scotland,435,234872,4296.963044273692,63.794365166483715,2,7708,141.01719721917308,3034,1550503,28366.319063300405,12378,464,3.7485862013249314,2.433112043387481,4933,7445,26.0,,1.0,,27,437,435,234872,7708
2021-05-30,S92000003,Scotland,486,235358,4305.8543724844485,66.75814123673621,1,7709,141.03549213318698,2919,1553422,28419.721917306986,12839,526,4.096892281330321,2.542049547656154,6362,6477,21.0,,1.0,,21,505,486,235358,7709
2021-05-31,S92000003,Scotland,601,235959,4316.8496158068065,68.67910720819613,0,7709,141.03549213318698,4475,1557897,28501.591657519213,26443,676,2.556442158605302,2.6829380673104137,17715,8728,23.0,,0.0,,35,641,601,235959,7709
2021-06-01,S92000003,Scotland,773,236732,4330.991584339554,73.60043907793633,0,7709,141.03549213318698,5870,1563767,28608.982802780825,31093,867,2.7884089666484417,2.8554102166173267,19288,11805,31.0,,4.0,,46,821,773,236732,7709
2021-06-02,S92000003,Scotland,959,237691,4348.536406878888,79.67435053055252,1,7710,141.05378704720087,5442,1569209,28708.54372484449,26574,1017,3.827048995258523,3.042130713238509,14594,11980,22.0,,2.0,,44,973,959,237691,7710
2021-06-03,S92000003,Scotland,949,238640,4365.898280278083,86.93743139407246,2,7712,141.09037687522869,5262,1574471,28804.811562385654,28337,1024,3.6136499982355232,3.250155682897525,12195,16142,34.0,,0.0,,65,959,949,238640,7712
2021-06-04,S92000003,Scotland,822,239462,4380.936699597512,91.93194291986828,1,7713,141.10867178924258,5688,1580159,28908.873033296743,26186,889,3.3949438631329714,3.3341470857491613,10340,15846,21.0,,1.0,,42,847,822,239462,7713
2021-06-05,S92000003,Scotland,606,240068,4392.023417489938,95.06037321624588,0,7713,141.10867178924258,3847,1584006,28979.253567508236,14138,652,4.6116848210496535,3.412233560775316,5030,9108,21.0,,2.0,,23,629,606,240068,7713
2021-06-06,S92000003,Scotland,677,240745,4404.409074277352,98.55470179290155,1,7714,141.1269667032565,3680,1587686,29046.5788510794,14982,726,4.845814977973569,3.4878660888329867,6843,8139,29.0,,2.0,,35,691,677,240745,7714
2021-06-07,S92000003,Scotland,953,241698,4421.844127332602,104.99451152579584,1,7715,141.14526161727042,6508,1594194,29165.64215148189,31989,1021,3.191722154490606,3.575323573707869,18239,13750,29.0,,4.0,,44,977,953,241698,7715
2021-06-08,S92000003,Scotland,1026,242724,4440.614709110867,109.62312477131357,0,7715,141.14526161727042,6223,1600417,29279.49140139041,32778,1104,3.3681127585575688,3.67633612215974,20062,12716,23.0,,1.0,,48,1056,1026,242724,7715
2021-06-09,S92000003,Scotland,1056,243780,4459.93413830955,111.39773143066229,2,7717,141.1818514452982,5614,1606031,29382.199048664468,27482,1118,4.0681173131504265,3.714779523798695,14720,12762,31.0,,0.0,,49,1069,1056,243780,7717
2021-06-10,S92000003,Scotland,1040,244820,4478.96084888401,113.06256860592757,2,7719,141.21844127332602,5138,1611169,29476.198316867914,27493,1136,4.131960862765069,3.796672912572552,11831,15662,32.0,,2.0,,46,1090,1040,244820,7719
2021-06-11,S92000003,Scotland,865,245685,4494.7859495060375,113.84924990852542,0,7719,141.21844127332602,5217,1616386,29571.642883278448,24668,959,3.887627695800227,3.8702241687316317,10004,14664,25.0,,3.0,,43,916,865,245685,7719
2021-06-12,S92000003,Scotland,706,246391,4507.702158799853,115.67874130991585,0,7719,141.21844127332602,3739,1620125,29640.047566776437,14337,765,5.335844318895166,3.930834805933378,5058,9279,33.0,,1.0,,36,729,706,246391,7719
2021-06-13,S92000003,Scotland,855,247246,4523.344310281742,118.93523600439077,3,7722,141.27332601536773,3592,1623717,29705.762897914374,14971,919,6.138534500033398,4.042183308580573,6343,8628,24.0,,2.0,,36,883,855,247246,7722
2021-06-14,S92000003,Scotland,1129,248375,4543.999268203439,122.1551408708379,1,7723,141.29162092938162,7225,1630942,29837.94365166484,34762,1219,3.5067027213624065,4.090860157175153,19246,15516,41.0,,1.0,,63,1156,1129,248375,7723
2021-06-15,S92000003,Scotland,1279,249654,4567.398463227223,126.78375411635568,6,7729,141.4013904134651,6732,1637674,29961.10501280644,34481,1366,3.9616020417041273,4.198794572207818,19543,14938,33.0,,2.0,,68,1298,1279,249654,7729
2021-06-16,S92000003,Scotland,1265,250919,4590.541529454811,130.6073911452616,1,7730,141.41968532747896,6473,1644147,30079.527991218438,30130,1352,4.487222037836044,4.266707955010451,15025,15105,41.0,,0.0,,73,1279,1265,250919,7730
2021-06-17,S92000003,Scotland,1164,252083,4611.836809366996,132.87596048298573,1,7731,141.43798024149288,6066,1650213,30190.504939626782,30097,1249,4.1499152739475695,4.267740915582787,12347,17750,25.0,,1.0,,64,1185,1164,252083,7731
2021-06-18,S92000003,Scotland,1231,253314,4634.357848518112,139.57189901207465,3,7734,141.49286498353456,5494,1655707,30291.01719721917,25677,1323,5.152471083070452,4.4417337562006995,9943,15734,47.0,,4.0,,76,1247,1231,253314,7734
2021-06-19,S92000003,Scotland,997,254311,4652.597877789975,144.89571899012074,2,7736,141.5294548115624,4268,1659975,30369.09989023052,15914,1082,6.799044866155587,4.574481809581148,5061,10853,28.0,,1.0,,39,1043,997,254311,7736
2021-06-20,S92000003,Scotland,1548,255859,4680.918404683498,157.5740944017563,3,7739,141.58433955360408,4598,1664573,30453.21990486645,18716,1647,8.799957255823895,4.867818544923778,6628,12088,30.0,,1.0,,50,1597,1548,255859,7739
2021-06-21,S92000003,Scotland,3019,258878,4736.150750091474,192.15148188803516,2,7741,141.6209293816319,8699,1673272,30612.3673618734,41143,3163,7.687820528400942,5.700506734367193,19107,22036,36.0,,5.0,,93,3070,3019,258878,7741
2021-06-22,S92000003,Scotland,3243,262121,4795.481156238567,228.08269301134285,4,7745,141.69410903768753,8664,1681936,30770.874496889865,41984,3405,8.110232469512193,6.491669980997834,20108,21876,47.0,,0.0,,109,3296,3243,262121,7745
2021-06-23,S92000003,Scotland,2891,265012,4848.3717526527635,257.8302231979509,1,7746,141.71240395170142,8398,1690334,30924.515184778636,36501,3074,8.421687077066384,7.114630151595947,14843,21658,55.0,,1.0,,119,2955,2891,265012,7746
2021-06-24,S92000003,Scotland,2947,267959,4902.286864251739,290.45005488474214,2,7748,141.74899377972926,8153,1698487,31073.673618733996,37891,3098,8.176084030508564,7.708905273016077,12669,25222,51.0,,1.0,,123,2975,2947,267959,7748
2021-06-25,S92000003,Scotland,2619,270578,4950.201244054153,315.843395536041,1,7749,141.76728869374313,6991,1705478,31201.573362605195,31780,2809,8.838892385147892,8.162408620589561,10511,21269,43.0,,2.0,,90,2719,2619,270578,7749
2021-06-26,S92000003,Scotland,2292,272870,4992.133186974021,339.5353091840468,8,7757,141.91364800585438,5039,1710517,31293.761434321266,20060,2441,12.168494516450648,8.609887098542147,5382,14678,31.0,,0.0,,89,2352,2292,272870,7757
2021-06-27,S92000003,Scotland,2511,275381,5038.071716062934,357.1533113794365,3,7760,141.9685327478961,4779,1715296,31381.192828393705,20614,2628,12.748617444455226,8.965400286120545,6590,14024,36.0,,3.0,,76,2552,2511,275381,7760
2021-06-28,S92000003,Scotland,3922,279303,5109.824368825466,373.673618733992,3,7763,142.02341748993783,8852,1724148,31543.13940724479,43063,4145,9.625432505863502,9.31464080416399,19601,23462,59.0,,2.0,,161,3984,3922,279303,7763
2021-06-29,S92000003,Scotland,3873,283176,5180.680570801317,385.1994145627516,3,7766,142.0783022319795,7964,1732112,31688.84010245152,40799,4098,10.044363832446873,9.662863879882797,19456,21343,69.0,,0.0,,149,3949,3873,283176,7766
2021-06-30,S92000003,Scotland,3907,287083,5252.158799853641,403.7870472008782,1,7767,142.09659714599346,7922,1740034,31833.772411269667,37024,4160,11.235955056179774,10.110668552226992,15079,21945,68.0,,3.0,,159,4001,3907,287083,7767
2021-07-01,S92000003,Scotland,3429,290512,5314.892060007318,412.60519575558,2,7769,142.13318697402119,7338,1747372,31968.02049030369,36771,3672,9.986130374479886,10.409324195714243,13058,23713,63.0,,6.0,,150,3522,3429,290512,7769
2021-07-02,S92000003,Scotland,3078,293590,5371.203805342115,421.002561287962,2,7771,142.16977680204903,6641,1754013,32089.51701427003,31788,3333,10.485088712721783,10.636670592171876,10161,21627,67.0,,3.0,,167,3166,3078,293590,7771
2021-07-03,S92000003,Scotland,2509,296099,5417.105744603001,424.97255762897913,4,7775,142.24295645810463,5115,1759128,32183.095499451152,21238,2714,12.778981071663996,10.700527892709374,5570,15668,56.0,,5.0,,106,2608,2509,296099,7775
2021-07-04,S92000003,Scotland,2407,298506,5461.141602634468,423.06988657153306,6,7781,142.3527259421881,4575,1763703,32266.79473106476,21093,2576,12.212582373299199,10.6559781858346,7565,13528,68.0,,4.0,,129,2447,2407,298506,7781
2021-07-05,S92000003,Scotland,3378,301884,5522.941822173436,413.1174533479692,5,7786,142.4442005122576,7890,1771593,32411.141602634467,40314,3687,9.145706206280694,10.583904954437687,19216,21098,83.0,,9.0,,186,3501,3378,301884,7786
2021-07-06,S92000003,Scotland,3091,304975,5579.491401390414,398.8108305890962,13,7799,142.68203439443838,7333,1778926,32545.298207098433,38691,3378,8.730712568814452,10.36493198013388,19752,18939,101.0,,2.0,,205,3173,3091,304975,7799
2021-07-07,S92000003,Scotland,2896,307871,5632.473472374681,380.3146725210392,5,7804,142.77350896450787,6145,1785071,32657.720453713868,31993,3221,10.06782733723002,10.176755840784539,14830,17163,89.0,,8.0,,193,3028,2896,307871,7804
2021-07-08,S92000003,Scotland,2729,310600,5682.400292718624,367.50823271130616,12,7816,142.9930479326747,5647,1790718,32761.031833150384,32434,3017,9.30196707159154,10.078556292547496,12803,19631,102.0,,7.0,,186,2831,2729,310600,7816
2021-07-09,S92000003,Scotland,2382,312982,5725.978777899742,354.774972557629,7,7823,143.12111233077206,5466,1796184,32861.03183315038,27587,2678,9.707470910211331,9.970002343566907,10185,17402,83.0,,5.0,,173,2505,2382,312982,7823
2021-07-10,S92000003,Scotland,1812,314794,5759.129162092938,342.0234174899378,8,7831,143.26747164288332,3918,1800102,32932.71130625686,17126,2017,11.777414457549925,9.83282195394718,5153,11973,83.0,,5.0,,116,1901,1812,314794,7831
2021-07-11,S92000003,Scotland,1881,316675,5793.541895353092,332.4002927186242,6,7837,143.37724112696668,3701,1803803,33000.420783022324,18203,2068,11.360764709113884,9.724349157733537,7378,10825,73.0,,5.0,,138,1930,1881,316675,7837
2021-07-12,S92000003,Scotland,2577,319252,5840.687888766923,317.746066593487,7,7844,143.50530552506402,6490,1810293,33119.154774972565,35275,2883,8.172927002126151,9.568374985718473,18336,16939,102.0,,7.0,,197,2686,2577,319252,7844
2021-07-13,S92000003,Scotland,2443,321695,5885.382363702891,305.8909623124772,9,7853,143.66995975118917,5902,1816195,33227.13135748262,34534,2711,7.850234551456535,9.431808959584485,19080,15454,104.0,,7.0,,257,2454,2443,321695,7853
2021-07-14,S92000003,Scotland,2204,323899,5925.704354189536,293.2308818148555,8,7861,143.8163190633004,5091,1821286,33320.270764727415,28491,2487,8.729072338633252,9.22334107926672,14401,14090,79.0,,4.0,,184,2303,2204,323899,7861
2021-07-15,S92000003,Scotland,1963,325862,5961.61727039883,279.2169776802049,7,7868,143.94438346139773,4709,1825995,33406.42151481888,28051,2221,7.917721293358526,9.016363127222391,12327,15724,79.0,,7.0,,190,2031,1963,325862,7868
2021-07-16,S92000003,Scotland,1749,327611,5993.6150750091465,267.6362971094036,5,7873,144.03585803146726,4459,1830454,33487.99853640688,24094,1955,8.114053291275836,8.79670998094459,9551,14543,68.0,,8.0,,135,1820,1749,327611,7873
2021-07-17,S92000003,Scotland,1400,329011,6019.2279546286145,260.0987925356751,7,7880,144.1639224295646,3286,1833740,33548.11562385657,14527,1578,10.862531837268534,8.681861607752149,4785,9742,49.0,,6.0,,101,1477,1400,329011,7880
2021-07-18,S92000003,Scotland,1385,330396,6044.56641053787,251.02451518477864,8,7888,144.31028174167582,3212,1836952,33606.878887669234,16413,1547,9.425455431670017,8.480304325054442,6969,9444,67.0,,6.0,,107,1440,1385,330396,7888
2021-07-19,S92000003,Scotland,1908,332304,6079.4731064764,238.78521770947674,9,7897,144.47493596780097,5910,1842862,33715.001829491404,32925,2147,6.5208807896735,8.180523361353924,18465,14460,77.0,,5.0,,175,1972,1908,332304,7897
2021-07-20,S92000003,Scotland,1598,333902,6108.708379070617,223.32601536772782,6,7903,144.5847054518844,5300,1848162,33811.964873765086,30845,1799,5.8323877451775,7.8325140008896685,18707,12138,67.0,,9.0,,160,1639,1598,333902,7903
2021-07-21,S92000003,Scotland,1573,335475,6137.48627881449,211.78192462495429,8,7911,144.7310647639956,4748,1852910,33898.82912550311,25516,1739,6.8153315566703245,7.533749876719402,13784,11732,74.0,,6.0,,140,1599,1573,335475,7911
2021-07-22,S92000003,Scotland,1378,336853,6162.696670325649,201.0793999268204,9,7920,144.89571899012074,4319,1857229,33977.84485912917,25588,1551,6.061435047678598,7.248628669632978,11448,14140,60.0,,10.0,,130,1421,1378,336853,7920
2021-07-23,S92000003,Scotland,1277,338130,6186.059275521405,192.44420051225757,7,7927,145.0237833882181,4021,1861250,34051.408708379066,22132,1437,6.492861015723839,7.024877043811703,9388,12744,62.0,,6.0,,115,1322,1277,338130,7927
2021-07-24,S92000003,Scotland,954,339084,6203.512623490669,184.28466886205638,3,7930,145.0786681302598,3187,1864437,34109.71459934139,13585,1064,7.832167832167832,6.756724389834974,4846,8739,43.0,,7.0,,81,983,954,339084,7930
2021-07-25,S92000003,Scotland,942,340026,6220.746432491767,176.18002195389684,5,7935,145.1701427003293,3069,1867506,34165.86169045005,14678,1035,7.051369396375528,6.5178587635914775,6958,7720,52.0,,6.0,,98,937,942,340026,7935
2021-07-26,S92000003,Scotland,1372,341398,6245.847054518844,166.3739480424442,7,7942,145.29820709842662,5949,1873455,34274.69813391877,31793,1551,4.87843235932438,6.199699031906273,18391,13402,53.0,,4.0,,128,1423,1372,341398,7942
2021-07-27,S92000003,Scotland,1353,342751,6270.600073179657,161.89169410903767,8,7950,145.44456641053787,4978,1878433,34365.77021587999,29538,1503,5.088360755636806,6.067677946324388,18218,11320,59.0,,5.0,,145,1358,1353,342751,7950
2021-07-28,S92000003,Scotland,1286,344037,6294.127332601537,156.64105378704718,9,7959,145.60922063666303,4171,1882604,34442.07830223198,23773,1418,5.964749926387078,5.934060476636847,13209,10564,67.0,,3.0,,121,1297,1286,344037,7959
2021-07-29,S92000003,Scotland,1171,345208,6315.550676911817,152.85400658616902,6,7965,145.71899012074644,4005,1886609,34515.34943285766,24706,1299,5.257832105561403,5.80943166567835,11155,13551,43.0,,3.0,,101,1198,1171,345208,7965
2021-07-30,S92000003,Scotland,1034,346242,6334.467618002196,148.40834248079034,7,7972,145.84705451884378,3794,1890403,34584.760336626416,21571,1141,5.289509063093969,5.644433865350405,9592,11979,52.0,,3.0,,99,1042,1034,346242,7972
2021-07-31,S92000003,Scotland,769,347011,6348.536406878888,145.0237833882181,6,7978,145.9568240029272,3252,1893655,34644.25539699964,13234,874,6.604201299682637,5.537594244568187,4912,8322,34.0,,5.0,,64,810,769,347011,7978
2021-08-01,S92000003,Scotland,873,347884,6364.5078668130245,143.7614343212587,10,7988,146.13977314306626,3197,1896852,34702.74423710209,14685,957,6.516853932584269,5.4883866917765225,6828,7857,38.0,,3.0,,95,862,873,347884,7988
2021-08-02,S92000003,Scotland,1322,349206,6388.693743139408,142.8466886205635,7,7995,146.26783754116357,5242,1902094,34798.64617636297,29534,1454,4.923139432518453,5.505568609471411,17371,12163,50.0,,5.0,,145,1309,1322,349206,7995
2021-08-03,S92000003,Scotland,1366,350572,6413.684595682401,143.08452250274425,3,7998,146.32272228320525,4843,1906937,34887.24844493232,29387,1481,5.039643379725729,5.496844923194594,18186,11201,49.0,,3.0,,112,1369,1366,350572,7998
2021-08-04,S92000003,Scotland,1292,351864,6437.321624588364,143.19429198682766,6,8004,146.4324917672887,4398,1911335,34967.709476765456,24314,1413,5.811466644731429,5.474779427177621,13453,10861,39.0,,4.0,,91,1322,1292,351864,8004
2021-08-05,S92000003,Scotland,1331,353195,6461.672155140872,146.12147822905234,7,8011,146.560556165386,4505,1915840,35050.128064398086,25971,1459,5.617804474221248,5.531960477894843,11809,14162,70.0,,3.0,,75,1384,1331,353195,8011
2021-08-06,S92000003,Scotland,1256,354451,6484.650567142336,150.18294914013902,7,8018,146.68862056348334,4301,1920141,35128.81448957189,21929,1385,6.315837475489078,5.672916116539037,9075,12854,55.0,,1.0,,105,1280,1256,354451,8018
2021-08-07,S92000003,Scotland,941,355392,6501.866081229417,153.32967435053058,6,8024,146.79839004756678,3366,1923507,35190.3951701427,13939,1021,7.324772221823659,5.739895717925124,4900,9039,41.0,,4.0,,63,958,941,355392,8024
2021-08-08,S92000003,Scotland,1040,356432,6520.892791803878,156.38492499085254,6,8030,146.90815953165017,3206,1926713,35249.04866447128,15540,1131,7.277992277992277,5.817674673440672,6946,8594,40.0,,3.0,,96,1035,1040,356432,8030
2021-08-09,S92000003,Scotland,1488,357920,6548.115623856568,159.42188071716063,6,8036,147.01792901573359,6345,1933058,35365.129893889505,33159,1617,4.876504116529449,5.788515517020928,17947,15212,37.0,,3.0,,114,1503,1488,357920,8036
2021-08-10,S92000003,Scotland,1518,359438,6575.887303329675,162.20270764727402,5,8041,147.10940358580314,5358,1938416,35463.154043176,30503,1666,5.461757859882634,5.861328656526867,18176,12327,70.0,,5.0,,141,1525,1518,359438,8041
2021-08-11,S92000003,Scotland,1567,361005,6604.555433589461,167.23380900109768,3,8044,147.16428832784487,5064,1943480,35555.799487742406,25658,1701,6.629511263543535,5.986838553320656,13292,12366,41.0,,2.0,,127,1574,1567,361005,8044
2021-08-12,S92000003,Scotland,1391,362396,6630.003658982801,168.33150384193198,4,8048,147.23746798390047,4696,1948176,35641.7124039517,26309,1537,5.842107263674028,6.021420403862617,11525,14784,39.0,,3.0,,110,1427,1391,362396,8048
2021-08-13,S92000003,Scotland,1523,363919,6657.8668130259775,173.21624588364438,10,8058,147.42041712403955,5017,1953193,35733.497987559465,23825,1670,7.009443861490032,6.122545624596733,9432,14393,41.0,,3.0,,110,1560,1523,363919,8058
2021-08-14,S92000003,Scotland,1471,365390,6684.778631540432,182.91255031101358,6,8064,147.5301866081229,3758,1956951,35802.250274423706,15665,1573,10.04149377593361,6.384075847157196,5160,10505,46.0,,2.0,,73,1500,1471,365390,8064
2021-08-15,S92000003,Scotland,1628,367018,6714.562751555067,193.6699597511892,6,8070,147.63995609220638,4151,1961102,35878.192462495426,18369,1734,9.439817083129183,6.627547726643917,7156,11213,31.0,,5.0,,93,1641,1628,367018,8070
2021-08-16,S92000003,Scotland,2746,369764,6764.800585437249,216.68496158068055,3,8073,147.69484083424808,7652,1968754,36018.185144529816,37464,2898,7.735426008968611,7.187572064142008,18043,19421,34.0,,5.0,,151,2747,2746,369764,8073
2021-08-17,S92000003,Scotland,3362,373126,6826.308086351994,250.4207830223198,4,8077,147.76802049030368,7585,1976339,36156.952067325285,38854,3561,9.165079528491276,7.883144232422211,18397,20457,61.0,,1.0,,185,3376,3362,373126,8077
2021-08-18,S92000003,Scotland,3704,376830,6894.072447859495,289.51701427003286,7,8084,147.89608488840102,7370,1983709,36291.785583607765,35704,3964,11.102397490477257,8.632957846985066,14300,21404,61.0,,1.0,,207,3757,3704,376830,8084
2021-08-19,S92000003,Scotland,3711,380541,6961.964873765093,331.9612147822905,7,8091,148.02414928649839,7803,1991512,36434.54079765825,37963,3938,10.373258172431052,9.304093454706416,12142,25821,59.0,,2.0,,182,3756,3711,380541,8091
2021-08-20,S92000003,Scotland,3422,383963,7024.570069520672,366.70325649469453,7,8098,148.1522136845957,7536,1999048,36572.41126966704,34135,3665,10.736780430643037,9.778871806155284,10504,23631,66.0,,1.0,,182,3483,3422,383963,8098
2021-08-21,S92000003,Scotland,3030,386993,7080.003658982802,395.225027442371,5,8103,148.24368825466522,5961,2005009,36681.46725210392,23382,3230,13.814044991874091,10.178376152759759,5527,17855,48.0,,5.0,,125,3105,3030,386993,8103
2021-08-22,S92000003,Scotland,3645,390638,7146.688620563484,432.1258690084156,4,8107,148.31686791072082,6551,2011560,36801.317233809,27718,3817,13.770834836568296,10.659382705552249,7490,20228,54.0,,6.0,,123,3694,3645,390638,8107
2021-08-23,S92000003,Scotland,5518,396156,7247.639956092207,482.839370654958,7,8114,148.44493230881815,11584,2023144,37013.24551774607,51981,5763,11.086743233104405,11.186968691063,19012,32969,77.0,,7.0,,248,5515,5518,396156,8114
2021-08-24,S92000003,Scotland,5597,401753,7350.036589828029,523.7285034760337,4,8118,148.51811196487375,10597,2033741,37207.116721551414,49734,5899,11.861101057626572,11.61704723790083,19376,30358,103.0,,5.0,,313,5586,5597,401753,8118
2021-08-25,S92000003,Scotland,6823,408576,7474.8627881448965,580.7903402854008,5,8123,148.6095865349433,11222,2044963,37412.42224661544,49771,7205,14.476301460689962,12.202021231669846,14707,35064,107.0,,7.0,,295,6910,6823,408576,8123
2021-08-26,S92000003,Scotland,7223,415799,7607.006952067325,645.042078302232,5,8128,148.70106110501283,12109,2057072,37633.95536040981,54748,7613,13.905530795645506,12.760190620614884,13103,41645,104.0,,9.0,,315,7298,7223,415799,8128
2021-08-27,S92000003,Scotland,6020,421819,7717.142334431028,692.5722649103549,10,8138,148.88401024515187,11335,2068407,37841.328210757405,47746,6397,13.397980982700126,13.0864035662777,10816,36930,106.0,,8.0,,262,6135,6020,421819,8138
2021-08-28,S92000003,Scotland,4736,426555,7803.787047200879,723.7833882180754,8,8146,149.0303695572631,8586,2076993,37998.40834248078,32833,5032,15.326043919227605,13.266100956662461,5744,27089,102.0,,4.0,,225,4807,4736,426555,8146
2021-08-29,S92000003,Scotland,4431,430986,7884.851811196488,738.163190633004,8,8154,149.1767288693743,7828,2084821,38141.62092938163,33053,4821,14.585665446404256,13.358718963565993,7961,25092,92.0,,7.0,,220,4601,4431,430986,8154
2021-08-30,S92000003,Scotland,6519,437505,8004.116355653127,756.4763995609219,6,8160,149.28649835345774,13897,2098718,38395.86534943285,63770,6954,10.904814175944804,13.242978396224995,20965,42805,114.0,,6.0,,324,6630,6519,437505,8160
2021-08-31,S92000003,Scotland,6957,444462,8131.394072447859,781.3574826198317,10,8170,149.46944749359673,15601,2114319,38681.284302963766,65813,7371,11.199914910428033,13.053943531549976,19686,46127,133.0,,8.0,,329,7042,6957,444462,8170
2021-09-01,S92000003,Scotland,7491,451953,8268.441273326016,793.5784851811197,8,8178,149.61580680570802,14907,2129226,38954.006586169045,61329,7923,12.918847527270946,12.833851018113403,15484,45845,155.0,,8.0,,368,7555,7491,451953,8178
2021-09-02,S92000003,Scotland,7526,459479,8406.128796194658,799.1218441273328,11,8189,149.81705085986098,14110,2143336,39212.14782290523,61358,8023,13.075719547573259,12.714060048865544,13812,47546,131.0,,8.0,,374,7649,7526,459479,8189
2021-09-03,S92000003,Scotland,6130,465609,8518.27661909989,801.1342846688623,11,8200,150.0182949140139,12269,2155605,39436.608122941834,50379,6588,13.076877270291195,12.675051216302386,10976,39403,154.0,,7.0,,298,6290,6130,465609,8200
2021-09-04,S92000003,Scotland,4986,470595,8609.495060373216,805.7080131723383,10,8210,150.20124405415297,9576,2165181,39611.80021953897,35495,5357,15.092266516410765,12.671708014881586,5959,29536,124.0,,7.0,,221,5136,4986,470595,8210
2021-09-05,S92000003,Scotland,4900,475495,8699.140139041347,814.288327844859,17,8227,150.51225759238932,9485,2174666,39785.32747896085,37407,5263,14.06955917341674,12.642490633762126,7849,29558,113.0,,16.0,,211,5052,4900,475495,8227
2021-09-06,S92000003,Scotland,7086,482581,8828.77789974387,824.6615440907428,10,8237,150.6952067325284,17394,2192060,40103.549213318685,70065,7546,10.769999286376937,12.589106603185575,20180,49885,158.0,,13.0,,435,7111,7086,482581,8237
2021-09-07,S92000003,Scotland,6657,489238,8950.567142334432,819.1730698865715,18,8255,151.02451518477864,16015,2208075,40396.542261251365,66712,7093,10.632270056361675,12.486903813243805,20306,46406,202.0,,12.0,,450,6643,6657,489238,8255
2021-09-08,S92000003,Scotland,6208,495446,9064.141968532747,795.7006952067325,10,8265,151.20746432491768,14744,2222819,40666.282473472376,59099,6650,11.252305453560972,12.225536444029801,15644,43455,167.0,,10.0,,397,6253,6208,495446,8265
2021-09-09,S92000003,Scotland,5516,500962,9165.056714233442,758.9279180387853,17,8282,151.51847786315406,13487,2236306,40913.0259787779,55560,5950,10.709143268538515,11.861484800529466,13282,42278,165.0,,9.0,,323,5627,5516,500962,8282
2021-09-10,S92000003,Scotland,4756,505718,9252.067325283571,733.790706183681,25,8307,151.97585071350161,11391,2247697,41121.423344310286,46013,5133,11.15554299871775,11.608447121784467,10829,35184,170.0,,10.0,,315,4818,4756,505718,8307
2021-09-11,S92000003,Scotland,3616,509334,9318.221734357849,708.7266739846323,21,8328,152.36004390779362,8745,2256442,41281.41236736187,30441,3902,12.81823855983706,11.370747638223145,5660,24781,132.0,,13.0,,254,3648,3616,509334,8328
2021-09-12,S92000003,Scotland,3353,512687,9379.564581046468,680.4244420051226,22,8350,152.76253201609953,8670,2265112,41440.02927186242,32144,3603,11.208934793429568,11.075898387374526,7861,24283,138.0,,12.0,,215,3388,3353,512687,8350
2021-09-13,S92000003,Scotland,5053,517740,9472.008781558729,643.2308818148555,21,8371,153.1467252103915,15229,2280341,41718.64251738017,62677,5490,8.759193962697639,10.724919607765294,20489,42188,175.0,,9.0,,373,5117,5053,517740,8371
2021-09-14,S92000003,Scotland,4745,522485,9558.8181485547,608.2510062202707,20,8391,153.5126234906696,13617,2293958,41967.764361507514,58245,5110,8.773285260537385,10.412605068874043,19825,38420,158.0,,7.0,,368,4742,4745,522485,8391
2021-09-15,S92000003,Scotland,4050,526535,9632.912550311014,568.7705817782656,23,8414,153.9334065129894,11327,2305285,42174.990852542986,47341,4370,9.230899220548784,10.095030097376519,14318,33023,170.0,,11.0,,303,4067,4050,526535,8414
2021-09-16,S92000003,Scotland,3555,530090,9697.950969630445,532.8942553969996,16,8430,154.22612513721182,10214,2315499,42361.855104281014,43742,3888,8.888482465365096,9.823987922758052,12419,31323,157.0,,9.0,,294,3594,3555,530090,8430
2021-09-17,S92000003,Scotland,3354,533444,9759.312111233075,507.244785949506,24,8454,154.66520307354554,9036,2324535,42527.16794731065,37799,3676,9.725125003306967,9.61589556610508,10435,27364,140.0,,15.0,,270,3406,3354,533444,8454
2021-09-18,S92000003,Scotland,2604,536048,9806.952067325285,488.730332967435,21,8475,155.04939626783755,6938,2331473,42654.09806073912,25098,2838,11.307673918240496,9.436696781589731,5444,19654,115.0,,13.0,,198,2640,2604,536048,8475
2021-09-19,S92000003,Scotland,2781,538829,9857.83022319795,478.26564215148187,28,8503,155.56165386022687,7029,2338502,42782.693011342846,27792,3011,10.83405296488198,9.376796368609883,7503,20289,103.0,,6.0,,201,2810,2781,538829,8503
2021-09-20,S92000003,Scotland,3991,542820,9930.845225027442,458.8364434687157,20,8523,155.92755214050496,12238,2350740,43006.58616904501,53278,4284,8.040842373962986,9.266097274075591,18882,34396,150.0,,7.0,,383,3901,3991,542820,8523
2021-09-21,S92000003,Scotland,3780,546600,10000.0,441.1818514452983,21,8544,156.31174533479694,11095,2361835,43209.568240029264,50955,4056,7.959964674712982,9.13375640286009,19377,31578,118.0,,8.0,,345,3711,3780,546600,8544
2021-09-22,S92000003,Scotland,3488,550088,10063.812660080495,430.9001097694841,31,8575,156.87888766922796,9709,2371544,43387.193560190266,43389,3771,8.691142916407385,9.049363062970436,14973,28416,107.0,,10.0,,340,3431,3488,550088,8575
2021-09-23,S92000003,Scotland,3096,553184,10120.453713867544,422.50274423710215,19,8594,157.22649103549213,8661,2380205,43545.64581046469,40341,3374,8.36369946208572,8.975352769763003,12034,28307,130.0,,4.0,,249,3125,3096,553184,8594
2021-09-24,S92000003,Scotland,2698,555882,10169.813391877058,410.50128064398103,22,8616,157.62897914379803,7489,2387694,43682.65642151482,32332,2913,9.00964988246938,8.875670333290627,9389,22943,108.0,,9.0,,241,2672,2698,555882,8616
2021-09-25,S92000003,Scotland,2125,558007,10208.690084156604,401.73801683132086,21,8637,158.01317233809004,5857,2393551,43789.80973289426,21895,2271,10.37223110299155,8.770955100710419,5218,16677,86.0,,7.0,,143,2128,2125,558007,8637
2021-09-26,S92000003,Scotland,2135,560142,10247.74972557629,389.91950237833885,20,8657,158.3790706183681,5465,2399016,43889.79143798024,23572,2284,9.689462073646698,8.636674919664964,7346,16226,83.0,,2.0,,178,2106,2135,560142,8657
2021-09-27,S92000003,Scotland,3112,563254,10304.68349798756,373.83827296011714,24,8681,158.8181485547018,9297,2408313,44059.87925356751,44786,3339,7.4554548296342595,8.554436972830102,18051,26735,117.0,,9.0,,307,3032,3112,563254,8681
2021-09-28,S92000003,Scotland,3175,566429,10362.769849981703,362.7698499817051,16,8697,159.11086717892425,9584,2417897,44235.21770947677,46495,3422,7.359931175395204,8.454570626161939,19166,27329,118.0,,5.0,,327,3095,3175,566429,8697
2021-09-29,S92000003,Scotland,2586,569015,10410.080497621659,346.26783754116354,25,8722,159.56824002927186,7962,2425859,44380.88181485547,38315,2832,7.391361085736658,8.248700229276325,14843,23472,103.0,,5.0,,252,2580,2586,569015,8722
2021-09-30,S92000003,Scotland,2360,571375,10453.256494694477,332.80278082693013,16,8738,159.86095865349432,7110,2432969,44510.95865349434,35795,2551,7.1266936723006005,8.064476335375634,12433,23362,92.0,,6.0,,241,2310,2360,571375,8738
2021-10-01,S92000003,Scotland,2040,573415,10490.57811928284,320.76472740578123,19,8757,160.2085620197585,6379,2439348,44627.66190998902,29635,2210,7.457398346549687,7.862598911402826,9665,19970,102.0,,6.0,,187,2023,2040,573415,8757
2021-10-02,S92000003,Scotland,1860,575275,10524.6066593487,315.91657519209656,23,8780,160.6293450420783,5075,2444423,44720.50859860959,20179,1983,9.8270479211061,7.798489804294383,5577,14602,88.0,,8.0,,157,1826,1860,575275,8780
2021-10-03,S92000003,Scotland,1979,577254,10560.812294182215,313.06256860592754,15,8795,160.90376875228688,4862,2449285,44809.45847054519,22451,2094,9.326978753730346,7.7553270272999635,7495,14956,86.0,,7.0,,150,1944,1979,577254,8795
2021-10-04,S92000003,Scotland,2945,580199,10614.690815953165,310.00731796560564,14,8809,161.15989754848155,9772,2459057,44988.236370289065,46076,3144,6.8235089851549615,7.631849874030116,18999,27077,132.0,,7.0,,262,2882,2945,580199,8809
2021-10-05,S92000003,Scotland,2831,583030,10666.483717526527,303.71386754482256,23,8832,161.58068057080132,8340,2467397,45140.815953165016,41947,3017,7.192409469091951,7.607146818658862,18357,23590,108.0,,6.0,,276,2741,2831,583030,8832
2021-10-06,S92000003,Scotland,2637,585667,10714.727405781192,304.6469081595316,13,8845,161.8185144529821,7150,2474547,45271.62458836444,35655,2857,8.012901416351143,7.705253346451597,14267,21388,86.0,,7.0,,259,2598,2637,585667,8845
2021-10-07,S92000003,Scotland,2594,588261,10762.184412733259,308.92791803878515,19,8864,162.16611781924627,6784,2481331,45395.73728503477,34484,2779,8.058809882844217,7.848038641305054,12203,22281,119.0,,4.0,,251,2528,2594,588261,8864
2021-10-08,S92000003,Scotland,2279,590540,10803.878521770948,313.30040248810826,14,8878,162.4222466154409,6179,2487510,45508.78155872667,28912,2462,8.515495296070835,7.982446975237697,9669,19243,108.0,,9.0,,222,2240,2279,590540,8878
2021-10-09,S92000003,Scotland,2129,592669,10842.82839370655,318.2217343578485,17,8895,162.73326015367732,4720,2492230,45595.13355287231,19132,2258,11.802216182312355,8.139265362529903,5218,13914,93.0,,9.0,,177,2081,2129,592669,8895
2021-10-10,S92000003,Scotland,1879,594548,10877.204537138676,316.3922429564581,14,8909,162.98938894987194,4546,2496776,45678.30223197951,20432,1992,9.749412685982774,8.16676815008957,7099,13333,74.0,,5.0,,158,1834,1879,594548,8909
2021-10-11,S92000003,Scotland,2813,597361,10928.668130259788,313.9773143066228,22,8931,163.39187705817784,7955,2504731,45823.83827296011,40202,3004,7.47226506143973,8.320650105995544,18014,22188,90.0,,3.0,,254,2750,2813,597361,8931
2021-10-12,S92000003,Scotland,2621,599982,10976.619099890231,310.1353823637029,16,8947,163.68459568240033,7286,2512017,45957.13501646542,37693,2783,7.383333775502082,8.376056533185535,17679,20014,99.0,,3.0,,242,2541,2621,599982,8947
2021-10-13,S92000003,Scotland,2630,602612,11024.734723746797,310.00731796560564,19,8966,164.03219904866447,6256,2518273,46071.587998536415,32318,2779,8.598923200693113,8.47058492398193,13803,18515,84.0,,3.0,,203,2576,2630,602612,8966
2021-10-14,S92000003,Scotland,2673,605285,11073.637028905965,311.452616172704,20,8986,164.39809732894255,5534,2523807,46172.832052689344,30928,2870,9.279617175375064,8.657694748040475,11609,19319,117.0,,9.0,,269,2601,2673,605285,8986
2021-10-15,S92000003,Scotland,2568,607853,11120.61836809367,316.73984632272226,16,9002,164.69081595316499,5500,2529307,46273.45407976583,27327,2705,9.89863504958466,8.840466851253654,9649,17678,125.0,,8.0,,219,2486,2568,607853,9002
2021-10-16,S92000003,Scotland,2149,610002,11159.93413830955,317.10574460300035,18,9020,165.02012440541532,4722,2534029,46359.84266373948,19410,2258,11.633178773827925,8.82866881090682,5136,14274,81.0,,3.0,,148,2110,2149,610002,9020
2021-10-17,S92000003,Scotland,2299,612301,11201.994145627517,324.78960848884014,15,9035,165.29454811562383,4827,2538856,46448.152213684596,22168,2435,10.984301696138578,8.966607314588233,7027,15141,68.0,,4.0,,150,2285,2299,612301,9035
2021-10-18,S92000003,Scotland,2950,615251,11255.964141968532,327.2960117087449,15,9050,165.5689718258324,8858,2547714,46610.208562019754,43462,3127,7.194790851778565,8.887232426654665,18228,25234,121.0,,7.0,,257,2870,2950,615251,9050
2021-10-19,S92000003,Scotland,2764,618015,11306.531284302964,329.91218441273327,9,9059,165.73362605195754,8565,2556279,46766.904500548844,42041,2948,7.012202373873124,8.78550359745284,17747,24294,129.0,,10.0,,273,2675,2764,618015,9059
2021-10-20,S92000003,Scotland,2840,620855,11358.488840102451,333.7541163556532,16,9075,166.02634467618003,8123,2564402,46915.514087083786,37433,3066,8.190633932626293,8.712612616656719,13961,23472,119.0,,9.0,,309,2757,2840,620855,9075
2021-10-21,S92000003,Scotland,2536,623391,11404.884742041711,331.24771313574826,22,9097,166.4288327844859,7592,2571994,47054.40907427736,35936,2720,7.569011576135352,8.455199603120596,11529,24407,99.0,,8.0,,231,2489,2536,623391,9097
2021-10-22,S92000003,Scotland,2444,625835,11449.597511891694,328.97914379802415,16,9113,166.7215514087084,7626,2579620,47193.926088547385,32425,2614,8.061680801850423,8.231025228126677,9932,22493,108.0,,11.0,,184,2430,2444,625835,9113
2021-10-23,S92000003,Scotland,2132,627967,11488.60226856934,328.6681302597878,23,9136,167.14233443102816,6137,2585757,47306.20197585072,22734,2295,10.09501187648456,8.130855761455383,5275,17459,80.0,,5.0,,185,2110,2132,627967,9136
2021-10-24,S92000003,Scotland,2319,630286,11531.028174167583,329.0340285400658,21,9157,167.52652762532014,6548,2592305,47425.99707281376,26397,2478,9.387430389817023,8.005723127090022,7441,18956,72.0,,3.0,,176,2302,2319,630286,9157
2021-10-25,S92000003,Scotland,3296,633582,11591.328210757407,335.3640687888767,8,9165,167.6728869374314,10643,2602948,47620.70984266374,48643,3553,7.3042369919618455,8.01029278243061,18377,30266,123.0,,9.0,,333,3220,3296,633582,9165
2021-10-26,S92000003,Scotland,2916,636498,11644.676180021954,338.14489571899014,19,9184,168.02049030369557,9904,2612852,47801.902671057454,46008,3148,6.842288297687357,7.9631054268038595,18957,27051,115.0,,8.0,,305,2843,2916,636498,9184
2021-10-27,S92000003,Scotland,2651,639149,11693.175997072813,334.68715697036225,14,9198,168.27661909989024,8073,2620925,47949.5975118917,37394,2888,7.723164143980317,7.893017869093562,14666,22728,111.0,,9.0,,292,2596,2651,639149,9198
2021-10-28,S92000003,Scotland,2497,641646,11738.858397365531,333.97365532382,20,9218,168.6425173801683,6978,2627903,48077.25942188072,34222,2705,7.904272105663023,7.941555061475327,11872,22350,110.0,,11.0,,246,2459,2497,641646,9218
2021-10-29,S92000003,Scotland,2547,644193,11785.455543358943,335.85803146725215,19,9237,168.9901207464325,7492,2635395,48214.32491767289,31747,2726,8.58663810753772,8.008658884460539,10343,21404,105.0,,9.0,,290,2436,2547,644193,9237
2021-10-30,S92000003,Scotland,2029,646222,11822.575923893159,333.97365532382,16,9253,169.28283937065495,6252,2641647,48328.704720087815,21957,2177,9.914833538279362,7.986020911806728,5215,16742,77.0,,6.0,,147,2030,2029,646222,9253
2021-10-31,S92000003,Scotland,2071,648293,11860.464690815952,329.4365166483717,16,9269,169.57555799487744,6611,2648258,48449.65239663373,23579,2215,9.393952245642307,7.9704372818723055,6441,17138,81.0,,4.0,,160,2055,2071,648293,9269
2021-11-01,S92000003,Scotland,3301,651594,11920.85620197585,329.52799121844123,27,9296,170.06952067325284,10727,2658985,48645.90193926089,47917,3480,7.262558173508358,7.964204526735412,18333,29584,128.0,,9.0,,320,3160,3301,651594,9296
2021-11-02,S92000003,Scotland,3046,654640,11976.582510062202,331.9063300402488,13,9309,170.3073545554336,9455,2668440,48818.880351262356,45941,3244,7.061230708952787,8.005948335166442,19930,26011,104.0,,6.0,,277,2967,3046,654640,9309
2021-11-03,S92000003,Scotland,2983,657623,12031.156238565678,337.980241492865,16,9325,170.60007317965602,7892,2676332,48963.26381266008,38403,3137,8.168632658906859,8.074957131019092,15048,23355,89.0,,4.0,,254,2883,2983,657623,9325
2021-11-04,S92000003,Scotland,2798,660421,12082.345407976585,343.4870106110501,22,9347,171.00256128796195,6816,2683148,49087.96194657885,35557,2955,8.3105998818798,8.132973753677057,12221,23336,86.0,,6.0,,222,2733,2798,660421,9347
2021-11-05,S92000003,Scotland,2781,663202,12133.223563849253,347.76802049030374,17,9364,171.3135748261983,6847,2689995,49213.22722283205,31987,2943,9.20061274892925,8.213466155269604,10790,21197,90.0,,8.0,,242,2701,2781,663202,9364
2021-11-06,S92000003,Scotland,2226,665428,12173.948042444199,351.3721185510428,17,9381,171.6245883644347,5085,2695080,49306.256860592766,20715,2335,11.272025102582667,8.319984924149628,5343,15372,61.0,,5.0,,125,2210,2226,665428,9381
2021-11-07,S92000003,Scotland,2301,667729,12216.044639590193,355.5799487742408,12,9393,171.84412733260154,4539,2699619,49389.297475301864,21553,2428,11.265253097016654,8.477607994282717,6545,15008,80.0,,6.0,,163,2265,2301,667729,9393
2021-11-08,S92000003,Scotland,3822,671551,12285.967800951335,365.11159897548487,12,9405,172.0636663007684,8890,2708509,49551.939260885476,47089,4015,8.526407441228312,8.728471056394952,18449,28640,102.0,,12.0,,272,3743,3822,671551,9405
2021-11-09,S92000003,Scotland,3454,675005,12349.15843395536,372.57592389315766,6,9411,172.1734357848518,8697,2717206,49711.0501280644,45071,3648,8.093896296953695,8.928133125325012,19300,25771,100.0,,5.0,,306,3342,3454,675005,9411
2021-11-10,S92000003,Scotland,3292,678297,12409.385290889131,378.22905232345414,14,9425,172.4295645810465,7195,2724401,49842.68203439444,37933,3464,9.131890438404557,9.081928263270877,14964,22969,80.0,,6.0,,236,3228,3292,678297,9425
2021-11-11,S92000003,Scotland,3214,681511,12468.185144529822,385.8397365532382,8,9433,172.57592389315772,6953,2731354,49969.88657153311,36740,3416,9.29776810016331,9.228580435359703,12401,24339,95.0,,7.0,,248,3168,3214,681511,9433
2021-11-12,S92000003,Scotland,2857,684368,12520.453713867544,387.2301500182949,17,9450,172.88693743139407,6593,2737947,50090.50493962678,33015,3043,9.217022565500528,9.23069933420344,11167,21848,82.0,,7.0,,225,2818,2857,684368,9450
2021-11-13,S92000003,Scotland,2320,686688,12562.897914379802,388.9498719356019,10,9460,173.06988657153312,4539,2742486,50173.5455543359,20757,2480,11.947776653659007,9.288976618571343,5405,15352,51.0,,4.0,,107,2373,2320,686688,9460
2021-11-14,S92000003,Scotland,2424,689112,12607.244785949506,391.2001463593122,15,9475,173.34431028174168,4214,2746700,50250.64032199049,21574,2577,11.944933716510613,9.349695886100776,6195,15379,73.0,,6.0,,156,2421,2424,689112,9475
2021-11-15,S92000003,Scotland,3642,692754,12673.874862788145,387.90706183680936,19,9494,173.69191364800582,7544,2754244,50388.657153311375,44406,3838,8.64297617439085,9.380532451481443,18125,26281,87.0,,13.0,,232,3606,3642,692754,9494
2021-11-16,S92000003,Scotland,3280,696034,12733.88218075375,384.72374679839004,5,9499,173.78338821807537,7442,2761686,50524.80790340285,43969,3478,7.9101184925743135,9.352584377123584,19803,24166,103.0,,3.0,,252,3226,3280,696034,9499
2021-11-17,S92000003,Scotland,3318,699352,12794.584705451885,385.1994145627516,12,9511,174.00292718624226,6399,2768085,50641.87705817783,36773,3503,9.526010931933753,9.414755051974,14457,22316,74.0,,6.0,,247,3256,3318,699352,9511
2021-11-18,S92000003,Scotland,2992,702344,12849.323088181485,381.1379436516648,9,9520,174.16758141236735,5968,2774053,50751.061105012814,34836,3138,9.00792283844299,9.37279564866358,11910,22926,79.0,,11.0,,209,2929,2992,702344,9520
2021-11-19,S92000003,Scotland,2785,705129,12900.274423710207,379.82070984266375,9,9529,174.33223563849248,5283,2779336,50847.713135748265,30112,2987,9.919633368756642,9.465767746432213,10617,19495,64.0,,1.0,,173,2814,2785,705129,9529
2021-11-20,S92000003,Scotland,2215,707344,12940.79765825101,377.89974387120384,10,9539,174.51518477863155,3949,2783285,50919.95975118917,19389,2354,12.140904636649644,9.467278920102656,5095,14294,50.0,,6.0,,91,2263,2215,707344,9539
2021-11-21,S92000003,Scotland,2174,709518,12980.570801317237,373.3260153677278,9,9548,174.6798390047567,3776,2787061,50989.04134650566,20313,2299,11.317875252301484,9.398254118834801,6382,13931,50.0,,6.0,,95,2204,2174,709518,9548
2021-11-22,S92000003,Scotland,3161,712679,13038.401024515184,364.5261617270399,15,9563,174.95426271496524,7017,2794078,51117.41675814123,42752,3340,7.8125,9.248106459078477,18212,24540,85.0,,8.0,,204,3136,3161,712679,9563
2021-11-23,S92000003,Scotland,2881,715560,13091.108671789243,357.2264910354921,12,9575,175.1738016831321,6879,2800957,51243.26747164288,41660,3068,7.364378300528084,9.16111320211659,19508,22152,63.0,,8.0,,208,2860,2881,715560,9575
2021-11-24,S92000003,Scotland,2897,718457,13144.109037687524,349.5243322356385,6,9581,175.2835711672155,5660,2806617,51346.81668496158,34429,3104,9.01565540677917,9.078665360126356,14253,20176,93.0,,5.0,,219,2885,2897,718457,9581
2021-11-25,S92000003,Scotland,2492,720949,13189.69996341017,340.37687522868634,10,9591,175.46652030735456,5270,2811887,51443.23088181487,32109,2653,8.26248092435143,8.97111847946223,11723,20386,69.0,,4.0,,168,2485,2492,720949,9591
2021-11-26,S92000003,Scotland,2237,723186,13230.625686059275,330.35126234906693,15,9606,175.74094401756312,4499,2816386,51525.53969996341,27324,2380,8.71029131898697,8.807391639446545,10721,16603,58.0,,4.0,,175,2205,2237,723186,9606
2021-11-27,S92000003,Scotland,1882,725068,13265.056714233442,324.25905598243685,13,9619,175.97877789974387,3402,2819788,51587.77899743871,17549,2025,11.539119038121829,8.730151386164268,5251,12298,60.0,,7.0,,138,1887,1882,725068,9619
2021-11-28,S92000003,Scotland,2332,727400,13307.720453713868,327.14965239663366,16,9635,176.27149652396633,3658,2823446,51654.70179290157,20168,2453,12.162832209440696,8.807311415753434,6025,14143,50.0,,6.0,,140,2313,2332,727400,9635
2021-11-29,S92000003,Scotland,3458,730858,13370.984266373947,332.5832418587633,11,9646,176.47274057811927,6753,2830199,51778.24734723747,44035,3654,8.29794481662314,8.899822344136895,18104,25931,82.0,,3.0,,248,3406,3458,730858,9646
2021-11-30,S92000003,Scotland,3295,734153,13431.266008049759,340.1573362605196,3,9649,176.527625320161,7127,2837326,51908.63519941457,44114,3491,7.913587523235253,8.99293672176509,19535,24579,65.0,,9.0,,239,3252,3295,734153,9649
2021-12-01,S92000003,Scotland,3092,737245,13487.833882180752,343.7248444932309,14,9663,176.78375411635562,6818,2844144,52033.369923161365,39370,3294,8.366776733553468,8.879729735744586,14469,24901,63.0,,2.0,,187,3107,3092,737245,9663
2021-12-02,S92000003,Scotland,2923,740168,13541.309915843394,351.60995243322355,12,9675,177.0032930845225,6538,2850682,52152.98207098427,37666,3131,8.312536505070886,8.87302042341004,12000,25666,54.0,,5.0,,173,2958,2923,740168,9675
2021-12-03,S92000003,Scotland,2641,742809,13589.626783754116,359.0010976948408,7,9682,177.13135748261985,6105,2856787,52264.67252103914,33131,2837,8.562977272041291,8.848339003444432,10454,22677,46.0,,3.0,,150,2687,2641,742809,9682
2021-12-04,S92000003,Scotland,2122,744931,13628.44859129162,363.3918770581777,12,9694,177.3508964507867,4587,2861374,52348.59129162093,21882,2293,10.478932455899828,8.800329497516287,5249,16633,55.0,,4.0,,122,2171,2122,744931,9694
2021-12-05,S92000003,Scotland,2482,747413,13673.85656787413,366.13611416026345,8,9702,177.4972557628979,4776,2866150,52435.96780095133,24359,2657,10.907672728765547,8.732933426563132,5983,18376,55.0,,2.0,,128,2529,2482,747413,9702
2021-12-06,S92000003,Scotland,3767,751180,13742.773508964507,371.78924259055987,13,9715,177.73508964507866,8292,2874442,52587.669227954626,49848,4013,8.050473439255336,8.673563126572674,18122,31726,88.0,,2.0,,268,3745,3767,751180,9715
2021-12-07,S92000003,Scotland,3722,754902,13810.86717892426,379.60117087449686,18,9733,178.064398097329,8016,2882458,52734.321258690085,49008,3984,8.129285014691481,8.700404287326062,19788,29220,82.0,,4.0,,242,3742,3722,754902,9733
2021-12-08,S92000003,Scotland,4124,759026,13886.3154043176,398.48152213684585,10,9743,178.24734723746795,8181,2890639,52883.99195023783,47093,4421,9.387807105089928,8.87344241350333,15361,31732,72.0,,5.0,,241,4180,4124,759026,9743
2021-12-09,S92000003,Scotland,3965,762991,13958.854738382726,417.544822539334,8,9751,178.3937065495792,7760,2898399,53025.960482985734,45054,4297,9.53744395614152,9.062228386500232,12603,32451,84.0,,2.0,,205,4092,3965,762991,9751
2021-12-10,S92000003,Scotland,3723,766714,14026.966703256494,437.3399195023784,7,9758,178.52177094767654,7295,2905694,53159.42188071717,40592,3968,9.77532518722901,9.225946241667748,11071,29521,55.0,,3.0,,195,3773,3723,766714,9758
2021-12-11,S92000003,Scotland,3232,769946,14086.09586534943,457.64727405781196,8,9766,178.66813025978774,5819,2911513,53265.87998536408,29236,3479,11.89971268299357,9.403906167817947,5635,23601,37.0,,2.0,,159,3320,3232,769946,9766
2021-12-12,S92000003,Scotland,3328,773274,14146.981339187705,473.1247713135749,8,9774,178.814489571899,5728,2917241,53370.67325283571,30758,3570,11.606736458807466,9.51064683510009,6662,24096,42.0,,6.0,,139,3431,3328,773274,9774
2021-12-13,S92000003,Scotland,5599,778873,14249.414562751555,506.6410537870472,5,9779,178.90596414196852,10526,2927767,53563.245517746065,63603,6072,9.546719494363472,9.756536889540977,19175,44428,76.0,,4.0,,311,5761,5599,778873,9779
2021-12-14,S92000003,Scotland,6258,785131,14363.90413465057,553.0369557263082,8,9787,179.05232345407975,10458,2938225,53754.57372850348,64171,6848,10.671487120350314,10.188545023977637,20481,43690,61.0,,3.0,,326,6522,6258,785131,9787
2021-12-15,S92000003,Scotland,6846,791977,14489.151115989756,602.8357116721552,6,9793,179.16209293816314,10434,2948659,53945.46286132456,60720,7552,12.43741765480896,10.710074401288106,16187,44533,68.0,,3.0,,310,7242,6846,791977,9793
2021-12-16,S92000003,Scotland,6268,798245,14603.823637028909,644.9688986461762,5,9798,179.25356750823272,9365,2958024,54116.794731064765,56368,6980,12.382912290661368,11.135974155299783,13535,42833,74.0,,6.0,,291,6689,6268,798245,9798
2021-12-17,S92000003,Scotland,5599,803844,14706.256860592757,679.2901573362606,6,9804,179.36333699231614,8561,2966585,54273.41748993778,48872,6196,12.678016041905384,11.505167812556538,11636,37236,64.0,,3.0,,274,5922,5599,803844,9804
2021-12-18,S92000003,Scotland,4919,808763,14796.249542627149,710.1536772777167,6,9810,179.47310647639958,6986,2973571,54401.225759238936,35437,5538,15.627733724638093,11.879009471312393,5834,29603,52.0,,2.0,,229,5309,4919,808763,9810
2021-12-19,S92000003,Scotland,5268,814031,14892.627149652395,745.6458104646907,4,9814,179.54628613245518,6456,2980027,54519.337724112695,36416,5938,16.306019332161686,12.342889654172607,6877,29539,46.0,,0.0,,204,5734,5268,814031,9814
2021-12-20,S92000003,Scotland,8078,822109,15040.413465056716,790.9989023051593,10,9824,179.72923527259422,10618,2990645,54713.59312111233,66712,9109,13.654215133709073,13.062523054223535,20741,45971,88.0,,9.0,,460,8649,8078,822109,9824
2021-12-21,S92000003,Scotland,9716,831825,15218.166849615807,854.2627149652395,7,9831,179.85729967069153,9998,3000643,54896.50567142334,68074,11082,16.27934306783794,14.0620345196847,21598,46476,73.0,,7.0,,567,10515,9716,831825,9831
2021-12-22,S92000003,Scotland,10894,842719,15417.471642883282,928.3205268935236,5,9836,179.94877424076103,9588,3010231,55071.91730698866,64663,12600,19.485640938403726,15.255403115721483,16585,48078,87.0,,8.0,,543,12057,10894,842719,9836
2021-12-23,S92000003,Scotland,11295,854014,15624.112696670325,1020.2890596414197,5,9841,180.0402488108306,7828,3018059,55215.12989388951,57565,13162,22.8645878572049,16.843640714885147,13602,43963,70.0,,2.0,,582,12580,11295,854014,9841
2021-12-24,S92000003,Scotland,8789,862803,15784.90669593853,1078.649835345774,3,9844,180.09513355287228,5138,3023197,55309.12916209294,38136,10196,26.73589259492343,18.4262798941698,9630,28506,78.0,,9.0,,568,9628,8789,862803,9844
2021-12-25,S92000003,Scotland,4484,867287,15866.941090376875,1070.6915477497257,2,9846,180.13172338090007,2016,3025213,55346.01170874497,14317,5065,35.37752322413913,19.414657557613413,2801,11516,50.0,,3.0,,219,4846,4484,867287,9846
2021-12-26,S92000003,Scotland,6815,874102,15991.62092938163,1098.9937797292353,1,9847,180.15001829491402,3627,3028840,55412.367361873396,26127,7724,29.563287021089288,20.542083589098734,6329,19798,85.0,,6.0,,473,7251,6815,874102,9847
2021-12-27,S92000003,Scotland,16855,890957,16299.981705085986,1259.5682400292715,5,9852,180.24149286498357,8734,3037574,55572.15514087084,67869,19428,28.625734871590858,23.535787570044338,16824,51045,111.0,,6.0,,976,18452,16855,890957,9852
2021-12-28,S92000003,Scotland,16728,907685,16606.019026710575,1387.8521770947675,3,9855,180.29637760702525,8529,3046103,55728.192462495426,69545,19053,27.39664965130491,25.790161491564714,18962,50583,,:,7.0,,1138,17915,16728,907685,9855
2021-12-29,S92000003,Scotland,6815,914500,16730.69886571533,1313.2272228320523,2,9857,180.33296743505304,4048,3050151,55802.25027442371,35112,7912,22.533606744133056,26.740445328521307,16211,18901,,:,4.0,,1171,6741,6815,914500,9857
2021-12-30,S92000003,Scotland,341,914841,16736.93743139407,1112.8247347237468,1,9858,180.35126234906696,334,3050485,55808.360775704365,3951,394,9.972158947101999,27.355453878936864,3942,9,,:,3.0,,393,1,341,914841,9858
