Date,HB,HBName,DailyPositive,CumulativePositive,CrudeRatePositive,CrudeRate7DayPositive,DailyDeaths,CumulativeDeaths,CrudeRateDeaths,DailyNegative,CumulativeNegative,CrudeRateNegative,TotalTests,PositiveTests,PositivePercentage,PositivePercentage7Day,TotalPillar1,TotalPillar2,HospitalAdmissions,HospitalAdmissionsQF,ICUAdmissions,ICUAdmissionsQF,PositivePillar1,PositivePillar2,DailyCases,CumulativeCases,Deaths
2020-02-28,S92000003,Scotland,1,1,0.01829491401390413,,0,0,0.0,121,700,12.806439809732895,164,2,1.2195121951219512,,164,0,,:,,:,2,0,1,1,0
2020-02-29,S92000003,Scotland,0,1,0.01829491401390413,,0,0,0.0,63,763,13.959019392608855,90,0,0.0,,90,0,,:,,:,0,0,0,1,0
2020-03-01,S92000003,Scotland,2,3,0.054884742041712405,,0,0,0.0,72,835,15.276253201609952,92,2,2.1739130434782608,,92,0,6.0,,,:,2,0,2,3,0
2020-03-02,S92000003,Scotland,1,4,0.07317965605561652,,0,0,0.0,189,1024,18.73399195023784,264,4,1.5151515151515151,,264,0,11.0,,,:,4,0,1,4,0
2020-03-03,S92000003,Scotland,3,7,0.12806439809732895,,0,0,0.0,209,1233,22.5576289791438,288,6,2.083333333333333,,288,0,13.0,,,:,6,0,3,7,0
2020-03-04,S92000003,Scotland,6,13,0.2378338821807537,,0,0,0.0,176,1409,25.77753384559093,255,10,3.92156862745098,,255,0,10.0,,,:,10,0,6,13,0
2020-03-05,S92000003,Scotland,2,15,0.27442371020856204,0.27442371020856204,0,0,0.0,175,1584,28.97914379802415,266,8,3.007518796992481,2.2551092318534183,266,0,19.0,,,:,8,0,2,15,0
2020-03-06,S92000003,Scotland,6,21,0.3841931942919868,0.3658982802780827,0,0,0.0,196,1780,32.56494694474936,324,12,3.7037037037037033,2.6599113362887903,324,0,21.0,,,:,12,0,6,21,0
2020-03-07,S92000003,Scotland,6,27,0.4939626783754116,0.4756677643615075,0,0,0.0,121,1901,34.77863154043176,218,17,7.79816513761468,3.456356180433509,218,0,10.0,,,:,17,0,6,27,0
2020-03-08,S92000003,Scotland,3,30,0.5488474204171241,0.4939626783754116,0,0,0.0,107,2008,36.7361873399195,192,17,8.854166666666668,4.095185390149418,192,0,11.0,,,:,17,0,3,30,0
2020-03-09,S92000003,Scotland,16,46,0.8415660446395901,0.7683863885839736,0,0,0.0,272,2280,41.71240395170143,453,39,8.609271523178807,5.460921843687375,453,0,18.0,,,:,39,0,16,46,0
2020-03-10,S92000003,Scotland,21,67,1.2257592389315772,1.0976948408342482,0,0,0.0,347,2627,48.06073911452616,588,47,7.993197278911565,6.533101045296168,588,0,30.0,,,:,47,0,21,67,0
2020-03-11,S92000003,Scotland,25,92,1.68313208927918,1.4452982070984266,0,0,0.0,418,3045,55.708013172338106,741,58,7.827260458839405,7.117181883537022,741,0,29.0,,1.0,,58,0,25,92,0
2020-03-12,S92000003,Scotland,38,130,2.3783388218075374,2.103915111598975,1,1,0.01829491401390413,514,3559,65.11159897548481,893,80,8.958566629339305,7.9202112056321505,893,0,24.0,,0.0,,80,0,38,130,1
2020-03-13,S92000003,Scotland,48,178,3.2564946944749362,2.8723015001829486,0,1,0.01829491401390413,527,4086,74.7530186608123,809,80,9.88875154511743,8.680020544427325,809,0,25.0,,0.0,,80,0,48,178,1
2020-03-14,S92000003,Scotland,19,197,3.6040980607391138,3.1101353823637035,2,3,0.054884742041712405,321,4407,80.62568605927551,525,20,3.8095238095238098,8.117114972625565,525,0,21.0,,1.0,,20,0,19,197,3
2020-03-15,S92000003,Scotland,12,209,3.823637028905964,3.2747896084888404,0,3,0.054884742041712405,271,4678,85.58360775704354,428,28,6.5420560747663545,7.933288257831867,428,0,16.0,,1.0,,28,0,12,209,3
2020-03-16,S92000003,Scotland,21,230,4.20783022319795,3.36626417855836,1,4,0.07317965605561652,483,5161,94.42005122575924,713,35,4.908835904628331,7.4089844581647855,713,0,33.0,,3.0,,35,0,21,230,4
2020-03-17,S92000003,Scotland,43,273,4.994511525795828,3.768752286864252,2,6,0.1097694840834248,548,5709,104.44566410537873,853,62,7.26846424384525,7.315598548972187,853,0,43.0,,1.0,,62,0,43,273,6
2020-03-18,S92000003,Scotland,41,314,5.744603000365897,4.061470911086719,0,6,0.1097694840834248,520,6229,113.95901939260885,895,56,6.256983240223464,7.056293979671619,895,0,43.0,,3.0,,56,0,41,314,6
2020-03-19,S92000003,Scotland,50,364,6.6593487010611065,4.281009879253569,3,9,0.16465422612513722,571,6800,124.40541529454813,946,61,6.4482029598308666,6.616366802089379,946,0,42.0,,4.0,,61,0,50,364,9
2020-03-20,S92000003,Scotland,84,448,8.196121478229053,4.939626783754116,5,14,0.2561287961946579,551,7351,134.48591291620932,946,97,10.253699788583507,6.7659253675084825,946,0,73.0,,8.0,,97,0,84,448,14
2020-03-21,S92000003,Scotland,67,515,9.421880717160633,5.817782656421515,6,20,0.3658982802780827,433,7784,142.40761068422978,704,81,11.505681818181818,7.657247037374657,704,0,63.0,,6.0,,81,0,67,515,20
2020-03-22,S92000003,Scotland,74,589,10.775704354189537,6.952067325283571,5,25,0.4573728503476034,353,8137,148.86571533113795,682,90,13.19648093841642,8.398675727478652,682,0,52.0,,8.0,,90,0,74,589,25
2020-03-23,S92000003,Scotland,138,727,13.300402488108304,9.092572264910356,4,29,0.5305525064032199,575,8712,159.38529088913282,1074,164,15.270018621973927,10.016393442622947,1074,0,96.0,,12.0,,164,0,138,727,29
2020-03-24,S92000003,Scotland,167,894,16.355653128430298,11.361141602634465,7,36,0.6586169045005489,655,9367,171.36845956824004,1261,206,16.33624107850912,11.601106330669944,1261,0,96.0,,10.0,,206,0,167,894,36
2020-03-25,S92000003,Scotland,188,1082,19.795096963044273,14.050493962678376,11,47,0.8598609586534943,662,10029,183.47969264544446,1374,251,18.26783114992722,13.596679547731506,1374,0,123.0,,13.0,,251,0,188,1082,47
2020-03-26,S92000003,Scotland,223,1305,23.87486278814489,17.215514087083786,12,59,1.0793999268203442,754,10783,197.27405781192826,1459,269,18.437285812200138,15.44,1459,0,155.0,,15.0,,269,0,223,1305,59
2020-03-27,S92000003,Scotland,274,1579,28.887669227954632,20.691547749725565,11,70,1.2806439809732897,706,11489,210.1902671057446,1445,322,22.28373702422145,17.289661207650955,1445,0,150.0,,16.0,,322,0,274,1579,70
2020-03-28,S92000003,Scotland,204,1783,32.61983168679107,23.19795096963044,29,99,1.8111964873765087,614,12103,221.42334431028166,1204,259,21.511627906976752,18.366866690198847,1204,0,156.0,,17.0,,259,0,204,1783,99
2020-03-29,S92000003,Scotland,197,1980,36.223929747530185,25.44822539334065,20,119,2.177094767654592,379,12482,228.35711672155145,948,262,27.637130801687764,19.7718197375927,948,0,136.0,,28.0,,262,0,197,1980,119
2020-03-30,S92000003,Scotland,317,2297,42.0234174899378,28.72301500182949,30,149,2.725942188071716,830,13312,243.54189535309186,1632,383,23.46813725490196,20.93746648074654,1632,0,193.0,,22.0,,383,0,317,2297,149
2020-03-31,S92000003,Scotland,341,2638,48.2619831686791,31.906330040248807,38,187,3.421148920600073,941,14253,260.75740944017565,1800,399,22.16666666666667,21.750152098965724,1800,0,184.0,,18.0,,399,0,341,2638,187
2020-04-01,S92000003,Scotland,389,3027,55.378704720087825,35.583607757043545,46,233,4.262714965239663,823,15076,275.8141236736187,1717,455,26.49970879440885,23.018128368446842,1717,0,216.0,,24.0,,455,0,389,3027,233
2020-04-02,S92000003,Scotland,351,3378,61.80021953896817,37.92535675082328,36,269,4.9213318697402135,746,15822,289.4621295279912,1618,416,25.710754017305327,24.083365495947515,1618,0,171.0,,18.0,,416,0,351,3378,269
2020-04-03,S92000003,Scotland,381,3759,68.77058177826564,39.882912550311005,58,327,5.9824368825466525,817,16639,304.4090742773509,1712,467,27.278037383177573,24.8424419151538,1712,0,212.0,,27.0,,467,0,381,3759,327
2020-04-04,S92000003,Scotland,260,4019,73.52725942188073,40.90742773508965,28,355,6.494694474935968,548,17187,314.43468715697037,1241,327,26.34971796937953,25.39370078740157,1241,0,154.0,,21.0,,327,0,260,4019,355
2020-04-05,S92000003,Scotland,225,4244,77.64361507500915,41.41968532747896,47,402,7.3545554335894625,479,17666,323.19795096963037,1117,294,26.32050134288273,25.292977761373077,1117,0,161.0,,25.0,,294,0,225,4244,402
2020-04-06,S92000003,Scotland,404,4648,85.03476033662642,43.01134284668861,63,465,8.507135016465423,809,18475,337.9985364068789,1798,522,29.032258064516128,26.17467963282741,1798,0,202.0,,15.0,,522,0,404,4648,465
2020-04-07,S92000003,Scotland,352,5000,91.47457006952068,43.21258690084157,49,514,9.403585803146727,778,19253,352.2319795096964,1696,449,26.474056603773583,26.883200293604922,1696,0,171.0,,16.0,,449,0,352,5000,514
2020-04-08,S92000003,Scotland,343,5343,97.7497255762898,42.371020856201966,54,568,10.391511159897547,746,19999,365.87998536406883,1657,417,25.16596258298129,26.681428176030998,1657,0,158.0,,13.0,,417,0,343,5343,568
2020-04-09,S92000003,Scotland,304,5647,103.31137943651665,41.511159897548474,66,634,11.59897548481522,782,20781,380.18660812294166,1653,389,23.5329703569268,26.34725032186868,1653,0,130.0,,12.0,,389,0,304,5647,634
2020-04-10,S92000003,Scotland,329,5976,109.33040614709113,40.55982436882547,58,692,12.660080497621662,774,21555,394.3468715697036,1691,403,23.83205204021289,25.808532203077487,1691,0,117.0,,8.0,,403,0,329,5976,692
2020-04-11,S92000003,Scotland,185,6161,112.71496523966336,39.18770581778266,50,742,13.574826198316867,531,22086,404.0614709110866,1184,261,22.04391891891892,25.33345683586513,1184,0,80.0,,9.0,,261,0,185,6161,742
2020-04-12,S92000003,Scotland,220,6381,116.73984632272229,39.096231247713135,48,790,14.452982070984266,452,22538,412.3307720453714,1062,294,27.683615819209038,25.463178475002326,1062,0,85.0,,8.0,,294,0,220,6381,790
2020-04-13,S92000003,Scotland,359,6740,123.30772045371387,38.27296011708746,41,831,15.203073545554336,736,23274,425.7958287596049,1575,429,27.23809523809524,25.11884388667047,1575,0,104.0,,8.0,,429,0,359,6740,831
2020-04-14,S92000003,Scotland,346,7086,129.6377607025247,38.16319063300403,51,882,16.136114160263446,726,24000,439.07793633369926,1629,438,26.887661141804784,25.17462443785284,1629,0,101.0,,6.0,,438,0,346,7086,882
2020-04-15,S92000003,Scotland,331,7417,135.69337724112697,37.94365166483717,42,924,16.90450054884742,862,24862,454.8481522136846,1740,399,22.931034482758626,24.80539206379343,1740,0,98.0,,6.0,,399,0,331,7417,924
2020-04-16,S92000003,Scotland,428,7845,143.52360043907794,40.212221002561286,43,967,17.6911818514453,978,25840,472.7405781192828,1969,513,26.053834433722702,25.22580645161291,1968,1,97.0,,9.0,,512,1,428,7845,967
2020-04-17,S92000003,Scotland,394,8239,150.73179656055618,41.40139041346506,38,1005,18.38638858397365,935,26775,489.84632272228316,1855,462,24.90566037735849,25.38587252587616,1855,0,110.0,,5.0,,462,0,394,8239,1005
2020-04-18,S92000003,Scotland,264,8503,155.56165386022687,42.84668862056349,52,1057,19.337724112696677,700,27475,502.6527625320162,1397,323,23.120973514674304,25.45648882159081,1397,0,74.0,,7.0,,323,0,264,8503,1057
2020-04-19,S92000003,Scotland,159,8662,158.4705451884376,41.730698865715325,46,1103,20.17929015733626,550,28025,512.7149652396633,1115,220,19.730941704035875,24.680851063829788,1115,0,58.0,,8.0,,220,0,159,8662,1103
2020-04-20,S92000003,Scotland,348,9010,164.83717526527627,41.52945481156239,61,1164,21.295279912184405,994,29019,530.9001097694841,1983,442,22.28946041351488,23.930527036276523,1983,0,65.0,,5.0,,442,0,348,9010,1164
2020-04-21,S92000003,Scotland,400,9410,172.1551408708379,42.51738016831321,51,1215,22.228320526893526,1021,30040,549.5792169776802,2123,476,22.42110221384833,23.272040715810213,2123,0,70.0,,5.0,,476,0,400,9410,1215
2020-04-22,S92000003,Scotland,340,9750,178.3754116355653,42.682034394438354,46,1261,23.069886571533107,1048,31088,568.7522868642518,2113,419,19.82962612399432,22.739944245320594,2113,0,65.0,,5.0,,419,0,340,9750,1261
2020-04-23,S92000003,Scotland,314,10064,184.1200146359312,40.59641419685328,49,1310,23.96633735821441,1047,32135,587.9070618368094,2034,396,19.469026548672566,21.695721077654518,2032,2,68.0,,7.0,,396,0,314,10064,1310
2020-04-24,S92000003,Scotland,306,10370,189.71825832418583,38.98646176362971,38,1348,24.66154409074277,1061,33196,607.3179656055618,1979,363,18.342597271349167,20.70778405524168,1978,1,91.0,,7.0,,363,0,306,10370,1348
2020-04-25,S92000003,Scotland,184,10554,193.08452250274425,37.52286864251738,48,1396,25.539699963410172,708,33904,620.2707647274058,1409,222,15.755855216465578,19.896519285042327,1406,3,42.0,,1.0,,222,0,184,10554,1396
2020-04-26,S92000003,Scotland,171,10725,196.21295279912187,37.742407610684225,43,1439,26.326381266008053,705,34609,633.1686791072083,1315,212,16.121673003802282,19.52763198518061,1205,110,39.0,,1.0,,204,8,171,10725,1439
2020-04-27,S92000003,Scotland,434,11159,204.15294548115622,39.31577021587999,60,1499,27.4240761068423,1852,36461,667.0508598609588,3362,536,15.942891136228434,18.304848273456575,2327,1035,76.0,,1.0,,435,101,434,11159,1499
2020-04-28,S92000003,Scotland,383,11542,211.1598975484815,39.004756677643606,40,1539,28.155872667398466,1905,38366,701.902671057446,3394,463,13.64172068355922,16.730744585415867,2405,989,72.0,,1.0,,387,76,383,11542,1539
2020-04-29,S92000003,Scotland,431,11973,219.04500548847423,40.66959385290889,38,1577,28.85107939992682,2840,41206,753.8602268569338,4607,498,10.809637508139787,14.861878453038676,2671,1936,49.0,,7.0,,380,118,431,11973,1577
2020-04-30,S92000003,Scotland,337,12310,225.21039151115986,41.090376875228685,43,1620,29.63776070252469,3031,44237,809.3121112330772,4937,435,8.811018837350618,12.993381897824126,3013,1924,56.0,,4.0,,369,66,337,12310,1620
2020-05-01,S92000003,Scotland,375,12685,232.070984266374,42.35272594218807,48,1668,30.51591657519209,3261,47498,868.9718258324186,5240,460,8.778625954198473,11.646884272997033,2934,2306,56.0,,6.0,,347,113,375,12685,1668
2020-05-02,S92000003,Scotland,222,12907,236.13245517746063,43.047932674716435,44,1712,31.320892791803878,2240,49738,909.9524332235637,3601,278,7.720077756178839,10.893559117024495,1834,1767,47.0,,3.0,,198,80,222,12907,1712
2020-05-03,S92000003,Scotland,188,13095,239.57189901207462,43.358946212952794,37,1749,31.997804610318326,2047,51785,947.4021222100256,3541,244,6.890708839310928,10.159682030541802,1721,1820,40.0,,2.0,,156,88,188,13095,1749
2020-05-04,S92000003,Scotland,330,13425,245.60922063666303,41.45627515550677,40,1789,32.729601170874496,2510,54295,993.3223563849248,4592,434,9.451219512195124,9.400909334046537,3087,1505,52.0,,3.0,,370,64,330,13425,1789
2020-05-05,S92000003,Scotland,288,13713,250.87815587266738,39.71825832418588,50,1839,33.6443468715697,2700,56995,1042.718624222466,4702,382,8.124202467035305,8.747597693786034,3098,1604,40.0,,2.0,,301,81,288,13713,1839
2020-05-06,S92000003,Scotland,307,14020,256.49469447493595,37.44968898646177,43,1882,34.43102817416757,2965,59960,1096.963044273692,5031,422,8.387994434506062,8.390216154721273,3180,1851,46.0,,2.0,,329,93,307,14020,1882
2020-05-07,S92000003,Scotland,297,14317,261.9282839370655,36.717892425905596,40,1922,35.16282473472375,2824,62784,1148.6278814489572,4910,394,8.024439918533602,8.267704083246356,3228,1682,37.0,,0.0,,313,81,297,14317,1922
2020-05-08,S92000003,Scotland,258,14575,266.6483717526528,34.577387486278816,34,1956,35.784851811196496,2782,65566,1199.5243322356387,4799,344,7.168160033340279,8.012573774698486,3184,1615,33.0,,4.0,,261,83,258,14575,1956
2020-05-09,S92000003,Scotland,180,14755,269.9414562751556,33.80900109769484,34,1990,36.40687888766922,1898,67464,1234.2480790340285,3508,246,7.012542759407071,7.933597143132903,2114,1394,21.0,,1.0,,167,79,180,14755,1990
2020-05-10,S92000003,Scotland,153,14908,272.7405781192828,33.1686791072082,28,2018,36.91913648005855,1760,69224,1266.4471276984998,3203,212,6.618794879800188,7.916734428362335,1942,1261,28.0,,1.0,,156,56,153,14908,2018
2020-05-11,S92000003,Scotland,265,15173,277.58873033296743,31.979509696304426,32,2050,37.50457372850347,3198,72422,1324.9542627149656,5786,364,6.291047355686137,7.401609317761983,4183,1603,33.0,,2.0,,278,86,265,15173,2050
2020-05-12,S92000003,Scotland,230,15403,281.7965605561654,30.918404683497982,31,2081,38.071716062934506,2926,75348,1378.4851811196488,5413,326,6.022538333641236,7.068912710566616,3964,1449,37.0,,0.0,,257,69,230,15403,2081
2020-05-13,S92000003,Scotland,198,15601,285.41895353091843,28.924259055982446,42,2123,38.840102451518476,3288,78636,1438.638858397365,5518,268,4.856832185574484,6.50028668859583,3670,1848,27.0,,0.0,,196,72,198,15601,2123
2020-05-14,S92000003,Scotland,211,15812,289.2791803878522,27.35089645078668,35,2158,39.480424442005116,3645,82281,1505.3238199780462,6194,293,4.730384242815628,5.964382208535488,4184,2010,28.0,,1.0,,218,75,211,15812,2158
2020-05-15,S92000003,Scotland,151,15963,292.0417124039517,25.393340651298928,26,2184,39.95609220636664,3004,85285,1560.281741675814,5354,238,4.445274561075832,5.5666742909423625,3545,1809,34.0,,2.0,,172,66,151,15963,2184
2020-05-16,S92000003,Scotland,103,16066,293.9260885473838,23.98463227222832,29,2213,40.48664471276985,2184,87469,1600.2378338821813,3998,149,3.726863431715858,5.21626346359894,2232,1766,19.0,,0.0,,97,52,103,16066,2213
2020-05-17,S92000003,Scotland,93,16159,295.62751555067695,22.88693743139407,26,2239,40.962312477131356,1727,89196,1631.833150384193,3487,130,3.728133065672498,4.945454545454545,2252,1235,10.0,,1.0,,83,47,93,16159,2239
2020-05-18,S92000003,Scotland,141,16300,298.2070984266374,20.61836809366996,23,2262,41.38309549945113,3497,92693,1695.8104646908166,6306,229,3.6314620995876936,4.502343534601597,4413,1893,29.0,,1.0,,180,49,141,16300,2262
2020-05-19,S92000003,Scotland,182,16482,301.53677277716787,19.740212221002558,28,2290,41.89535309184047,3893,96586,1767.0325649469448,6619,253,3.822329657047893,4.1626641050272175,3993,2626,14.0,,2.0,,191,62,182,16482,2290
2020-05-20,S92000003,Scotland,121,16603,303.7504573728504,18.331503841931948,22,2312,42.29784120014636,4017,100603,1840.5232345407971,6621,187,2.824346775411569,3.8336919049223668,4153,2468,19.0,,0.0,,138,49,121,16603,2312
2020-05-21,S92000003,Scotland,111,16714,305.78119282839367,16.50201244054153,24,2336,42.73691913648005,3277,103880,1900.4756677643616,5943,171,2.8773346794548207,3.5404925902734288,3957,1986,13.0,,0.0,,123,48,111,16714,2336
2020-05-22,S92000003,Scotland,91,16805,307.44603000365896,15.404317599707284,17,2353,43.047932674716435,3022,106902,1955.76289791438,5361,156,2.9099048684946833,3.325942350332594,3538,1823,16.0,,1.0,,104,52,91,16805,2353
2020-05-23,S92000003,Scotland,50,16855,308.3607757043542,14.434687156970362,11,2364,43.24917672886937,1948,108850,1991.401390413465,3843,104,2.7062190996617232,3.2215819800942898,2429,1414,14.0,,0.0,,70,34,50,16855,2364
2020-05-24,S92000003,Scotland,53,16908,309.3304061470912,13.702890596414196,8,2372,43.39553604098061,1938,110788,2026.856933772412,3733,96,2.571658183766408,3.112475927757248,2129,1604,8.0,,1.0,,57,39,53,16908,2372
2020-05-25,S92000003,Scotland,96,17004,311.0867178924259,12.879619465788512,14,2386,43.65166483717525,2979,113767,2081.3574826198314,5658,155,2.7394839165782963,2.9699825295145335,3968,1690,14.0,,1.0,,105,50,96,17004,2386
2020-05-26,S92000003,Scotland,478,17482,319.83168679107206,18.294914013904133,14,2400,43.90779363336992,4768,118535,2168.5876326381267,8603,553,6.4279902359642005,3.5762788592123127,3867,4736,14.0,,0.0,,84,469,478,17482,2400
2020-05-27,S92000003,Scotland,66,17548,321.03915111598974,17.288693743139408,16,2416,44.20051225759239,2690,121225,2217.8009513355287,5126,109,2.126414358174015,3.5121645281835527,3463,1663,11.0,,0.0,,84,25,66,17548,2416
2020-05-28,S92000003,Scotland,55,17603,322.0453713867545,16.264178558360776,16,2432,44.49323088181485,2566,123791,2264.745700695207,4942,105,2.1246458923512748,3.4293994525841245,3451,1491,7.0,,0.0,,69,36,55,17603,2432
2020-05-29,S92000003,Scotland,30,17633,322.5942188071716,15.148188803512626,11,2443,44.6944749359678,2165,125956,2304.354189535309,4431,61,1.3766644098397651,3.255724350506385,3166,1265,11.0,,0.0,,38,23,30,17633,2443
2020-05-30,S92000003,Scotland,40,17673,323.3260153677278,14.965239663373582,6,2449,44.80424442005122,1506,127462,2331.906330040249,3269,79,2.4166411746711534,3.238073933225212,2460,809,4.0,,0.0,,49,30,40,17673,2449
2020-05-31,S92000003,Scotland,23,17696,323.7467983900476,14.416392242956462,6,2455,44.914013904134656,1593,129055,2361.050128064398,3309,54,1.6319129646418855,3.1580734619955857,2489,820,11.0,,0.0,,37,17,23,17696,2455
2020-06-01,S92000003,Scotland,38,17734,324.44200512257595,13.35528723015002,3,2458,44.968898646176356,2270,131325,2402.579582875961,4682,88,1.8795386586928664,3.0527908736394846,3547,1135,6.0,,1.0,,65,23,38,17734,2458
2020-06-02,S92000003,Scotland,46,17780,325.2835711672156,5.451884376143432,6,2464,45.07866813025979,2536,133861,2448.975484815221,5249,88,1.6765098113926462,1.8833849329205368,3951,1298,5.0,,1.0,,70,18,46,17780,2464
2020-06-03,S92000003,Scotland,34,17814,325.90559824368825,4.8664471276985,8,2472,45.22502744237102,2576,136437,2496.103183315038,5206,70,1.3446023818670765,1.7530880082346885,3688,1518,9.0,,1.0,,45,25,34,17814,2472
2020-06-04,S92000003,Scotland,35,17849,326.5459202341749,4.5005488474204185,1,2473,45.24332235638492,2523,138960,2542.261251372119,5267,75,1.4239605088285552,1.6394486359150668,3742,1525,8.0,,0.0,,69,6,35,17849,2473
2020-06-05,S92000003,Scotland,24,17873,326.9849981705086,4.390779363336994,9,2482,45.40797658251006,2637,141597,2590.504939626784,5050,50,0.99009900990099,1.5734265734265735,3395,1655,10.0,,0.0,,41,9,24,17873,2482
2020-06-06,S92000003,Scotland,22,17895,327.3874862788145,4.061470911086719,3,2485,45.46286132455178,1968,143565,2626.509330406147,3836,39,1.0166840458811262,1.4233565446792846,2572,1264,6.0,,0.0,,27,12,22,17895,2485
2020-06-07,S92000003,Scotland,17,17912,327.69849981705084,3.951701427003293,7,2492,45.5909257226491,1568,145133,2655.195755579949,3384,28,0.8274231678486997,1.3405153945032748,2271,1113,7.0,,1.0,,14,14,17,17912,2492
2020-06-08,S92000003,Scotland,18,17930,328.0278082693012,3.5858031467252105,6,2498,45.70069520673253,2804,147937,2706.494694474936,5728,64,1.1173184357541899,1.2277580071174377,3900,1828,3.0,,0.0,,51,13,18,17930,2498
2020-06-09,S92000003,Scotland,27,17957,328.5217709476765,3.238199780461032,1,2499,45.71899012074643,3006,150943,2761.489206000732,5980,69,1.153846153846154,1.1465559780557897,4249,1731,8.0,,0.0,,55,14,27,17957,2499
2020-06-10,S92000003,Scotland,29,17986,329.05232345407984,3.146725210391512,5,2504,45.81046469081596,3220,154163,2820.3988291255027,6100,59,0.9672131147540984,1.086433724713538,3917,2183,8.0,,1.0,,49,10,29,17986,2504
2020-06-11,S92000003,Scotland,21,18007,329.4365166483717,2.890596414196853,2,2506,45.847054518843755,2789,156952,2871.4233443102808,6184,48,0.7761966364812419,0.984501682201754,4244,1940,7.0,,0.0,,42,6,21,18007,2506
2020-06-12,S92000003,Scotland,30,18037,329.9853640687889,3.0003658982802786,2,2508,45.88364434687157,2898,159850,2924.442005122576,6028,46,0.7631055076310551,0.9479054779806658,3936,2092,4.0,,0.0,,36,10,30,18037,2508
2020-06-13,S92000003,Scotland,22,18059,330.3878521770948,3.0003658982802786,3,2511,45.93852908891328,1847,161697,2958.2327113062565,4101,34,0.8290660814435503,0.9278762831622452,2611,1490,6.0,,0.0,,26,8,22,18059,2511
2020-06-14,S92000003,Scotland,13,18072,330.6256860592755,2.927186242224661,4,2515,46.0117087449689,1631,163328,2988.071716062935,3717,24,0.645682001614205,0.909138960833025,2409,1308,6.0,,0.0,,15,9,13,18072,2515
2020-06-15,S92000003,Scotland,21,18093,331.00987925356765,2.982070984266373,3,2518,46.066593487010614,2845,166173,3040.120746432492,6204,45,0.7253384912959381,0.8482539019679489,4215,1989,7.0,,0.0,,37,8,21,18093,2518
2020-06-16,S92000003,Scotland,17,18110,331.3208927918039,2.7991218441273324,6,2524,46.176362971094036,2950,169123,3094.0907427735087,6702,30,0.4476275738585497,0.7326570345322266,4266,2436,6.0,,1.0,,23,7,17,18110,2524
2020-06-17,S92000003,Scotland,33,18143,331.9246249542627,2.8723015001829486,3,2527,46.23124771313574,3228,172351,3153.1467252103917,7235,49,0.6772633033863165,0.6870628065022031,3954,3281,6.0,,1.0,,38,11,33,18143,2527
2020-06-18,S92000003,Scotland,14,18157,332.18075375045737,2.74423710208562,3,2530,46.28613245517746,3035,175386,3208.6717892425904,7281,35,0.4807032001098751,0.6372976640496268,3715,3566,5.0,,0.0,,24,11,14,18157,2530
2020-06-19,S92000003,Scotland,24,18181,332.6198316867911,2.6344676180021955,0,2530,46.28613245517746,3011,178397,3263.7577753384558,6812,39,0.5725190839694656,0.608770094169124,3618,3194,4.0,,0.0,,28,11,24,18181,2530
2020-06-20,S92000003,Scotland,6,18187,332.7296011708745,2.341748993779729,3,2533,46.34101719721917,1439,179836,3290.084156604464,4026,10,0.2483854942871337,0.5526836124544393,2795,1231,2.0,,0.0,,5,5,6,18187,2533
2020-06-21,S92000003,Scotland,9,18196,332.89425539699965,2.268569337724113,2,2535,46.377607025246974,1332,181168,3314.452982070984,3358,16,0.4764740917212627,0.5382286510644433,2405,953,1.0,,0.0,,12,4,9,18196,2535
2020-06-22,S92000003,Scotland,10,18206,333.0772045371387,2.067325283571168,3,2538,46.4324917672887,3164,184332,3372.3380900109773,7219,31,0.4294223576672669,0.492576173386813,3882,3337,8.0,,0.0,,28,3,10,18206,2538
2020-06-23,S92000003,Scotland,20,18226,333.4431028174168,2.12221002561288,1,2539,46.4507866813026,4145,188477,3448.1705085986096,10258,30,0.2924546695262234,0.4546537054276992,4299,5959,6.0,,0.0,,16,14,20,18226,2539
2020-06-24,S92000003,Scotland,8,18234,333.589462129528,1.6648371752652764,1,2540,46.469081595316496,3662,192139,3515.1664837175267,9795,17,0.17355793772332825,0.3651356950911813,3783,6012,5.0,,0.0,,9,8,8,18234,2540
2020-06-25,S92000003,Scotland,19,18253,333.9370654957922,1.756311745334797,0,2540,46.469081595316496,3212,195351,3573.929747530187,8990,34,0.3781979977753059,0.35078679297633675,3561,5429,3.0,,0.0,,23,11,19,18253,2540
2020-06-26,S92000003,Scotland,6,18259,334.04683497987565,1.4270032930845231,0,2540,46.469081595316496,2940,198291,3627.716794731065,8135,18,0.2212661339889367,0.3012688051601939,3318,4817,1.0,,0.0,,10,8,6,18259,2540
2020-06-27,S92000003,Scotland,4,18263,334.1200146359312,1.3904134650567141,4,2544,46.54226125137212,1495,199786,3655.0676911818514,3936,10,0.2540650406504065,0.3017933489388868,2483,1453,4.0,,0.0,,7,3,4,18263,2544
2020-06-28,S92000003,Scotland,3,18266,334.17489937797296,1.2806439809732897,1,2545,46.56055616538602,1162,200948,3676.3263812660084,3279,6,0.18298261665141813,0.28287995039913205,2321,958,4.0,,0.0,,4,2,3,18266,2545
2020-06-29,S92000003,Scotland,14,18280,334.43102817416764,1.3538236370289058,1,2546,46.57885107939993,2958,203906,3730.442736919137,8448,22,0.26041666666666663,0.25926837115118945,3969,4479,3.0,,0.0,,14,8,14,18280,2546
2020-06-30,S92000003,Scotland,8,18288,334.5773874862788,1.1342846688620565,0,2546,46.57885107939993,3626,207532,3796.780095133553,12223,19,0.1554446535220486,0.22990183556544905,4030,8193,1.0,,0.0,,10,9,8,18288,2546
2020-07-01,S92000003,Scotland,11,18299,334.77863154043166,1.1891694109037687,0,2546,46.57885107939993,3507,211039,3860.940358580314,11979,16,0.13356707571583604,0.21933672574135807,3767,8212,2.0,,0.0,,8,8,11,18299,2546
2020-07-02,S92000003,Scotland,13,18312,335.0164654226125,1.0793999268203442,0,2546,46.57885107939993,3016,214055,3916.1178192462494,10378,17,0.16380805550202351,0.18500119908184592,3447,6931,2.0,,0.0,,5,12,13,18312,2546
2020-07-03,S92000003,Scotland,6,18318,335.1262349066958,1.0793999268203442,1,2547,46.59714599341383,2810,216865,3967.5265276253203,9122,10,0.10962508221881166,0.16844942306072602,3374,5748,2.0,,0.0,,4,6,6,18318,2547
2020-07-04,S92000003,Scotland,5,18323,335.2177094767655,1.0976948408342482,0,2547,46.59714599341383,1597,218462,3996.743505305525,4369,8,0.18310826276035705,0.16388507976855413,2520,1849,2.0,,0.0,,6,2,5,18323,2547
2020-07-05,S92000003,Scotland,2,18325,335.25429930479334,1.0793999268203442,1,2548,46.61544090742774,1255,219717,4019.703622392975,3414,6,0.17574692442882248,0.16351592611749788,2448,966,2.0,,0.0,,6,0,2,18325,2548
2020-07-06,S92000003,Scotland,8,18333,335.4006586169045,0.9696304427369192,0,2548,46.61544090742774,2778,222495,4070.5268935236,8973,18,0.20060180541624875,0.15547983724238315,4020,4953,4.0,,0.0,,13,5,8,18333,2548
2020-07-07,S92000003,Scotland,11,18344,335.60190267105736,1.0245151847786316,0,2548,46.61544090742774,3186,225681,4128.814489571899,12551,12,0.0956099115608318,0.14312506169183692,4201,8350,2.0,,0.0,,1,11,11,18344,2548
2020-07-08,S92000003,Scotland,10,18354,335.7848518111965,1.0062202707647274,0,2548,46.61544090742774,3165,228846,4186.717892425906,13534,13,0.09605438155755874,0.13474278564668515,3586,9948,1.0,,1.0,,1,12,10,18354,2548
2020-07-09,S92000003,Scotland,8,18362,335.93121112330766,0.9147457006952068,0,2548,46.61544090742774,2961,231807,4240.889132821076,11869,11,0.09267840593141798,0.12219576388018548,3854,8015,1.0,,1.0,,2,9,8,18362,2548
2020-07-10,S92000003,Scotland,12,18374,336.1507500914745,1.0245151847786316,0,2548,46.61544090742774,2513,234320,4286.864251738017,8899,13,0.1460838296437802,0.12734047068811016,3471,5428,3.0,,0.0,,1,12,12,18374,2548
2020-07-11,S92000003,Scotland,9,18383,336.3154043175997,1.0976948408342482,0,2548,46.61544090742774,1599,235919,4316.11781924625,4479,12,0.2679169457468185,0.13339820147836595,2700,1779,4.0,,0.0,,8,4,9,18383,2548
2020-07-12,S92000003,Scotland,2,18385,336.35199414562754,1.0976948408342482,0,2548,46.61544090742774,1329,237248,4340.431759970728,3567,5,0.14017381553125874,0.1315130260521042,2429,1138,1.0,,0.0,,3,2,2,18385,2548
2020-07-13,S92000003,Scotland,18,18403,336.6813025978778,1.2806439809732897,0,2548,46.61544090742774,2987,240235,4395.07866813026,9704,24,0.2473206924979389,0.1393124158320821,4472,5232,1.0,,0.0,,8,16,18,18403,2548
2020-07-14,S92000003,Scotland,10,18413,336.86425173801683,1.2623490669593849,0,2548,46.61544090742774,3390,243625,4457.0984266373935,14817,13,0.08773705878382937,0.13608697602775574,4901,9916,2.0,,0.0,,3,10,10,18413,2548
2020-07-15,S92000003,Scotland,16,18429,337.1569703622393,1.37211855104281,0,2548,46.61544090742774,3062,246687,4513.117453347972,14011,20,0.14274498608236386,0.1455171799364476,4150,9861,1.0,,0.0,,3,17,16,18429,2548
2020-07-16,S92000003,Scotland,21,18450,337.5411635565313,1.609952433223564,0,2548,46.61544090742774,2697,249384,4562.458836443469,11860,23,0.193929173693086,0.16335744093143442,4280,7580,3.0,,0.0,,1,22,21,18450,2548
2020-07-17,S92000003,Scotland,8,18458,337.6875228686425,1.5367727771679471,0,2548,46.61544090742774,2543,251927,4608.982802780827,8946,10,0.11178180192264699,0.15879140448771226,3688,5258,2.0,,0.0,,4,6,8,18458,2548
2020-07-18,S92000003,Scotland,13,18471,337.92535675082325,1.609952433223564,0,2548,46.61544090742774,1384,253311,4634.302963776071,4089,16,0.3912937148447053,0.1656864793862137,2699,1390,1.0,,0.0,,5,11,13,18471,2548
2020-07-19,S92000003,Scotland,17,18488,338.23637028905966,1.8843761434321256,0,2548,46.61544090742774,1674,254985,4664.928649835346,4049,17,0.4198567547542604,0.18228703539036106,2453,1596,2.0,,0.0,,3,14,17,18488,2548
2020-07-20,S92000003,Scotland,13,18501,338.4742041712404,1.7929015733626052,0,2548,46.61544090742774,3339,258324,4726.015367727772,10984,17,0.15477057538237435,0.16871254872302055,4967,6017,1.0,,0.0,,2,15,13,18501,2548
2020-07-21,S92000003,Scotland,19,18520,338.82180753750464,1.9575557994877424,0,2548,46.61544090742774,3308,261632,4786.534943285767,15045,22,0.14622798271851115,0.18120143801461208,4946,10099,2.0,,0.0,,2,20,19,18520,2548
2020-07-22,S92000003,Scotland,16,18536,339.11452616172704,1.9575557994877424,0,2548,46.61544090742774,3320,264952,4847.274057811928,15129,25,0.16524555489457335,0.1854440672163419,4512,10617,2.0,,0.0,,7,18,16,18536,2548
2020-07-23,S92000003,Scotland,23,18559,339.5353091840468,1.9941456275155507,0,2548,46.61544090742774,2989,267941,4901.957555799488,12843,26,0.2024449116250097,0.18709995076317085,4196,8647,3.0,,0.0,,3,23,23,18559,2548
2020-07-24,S92000003,Scotland,11,18570,339.73655323819975,2.049030369557263,0,2548,46.61544090742774,2703,270644,4951.408708379071,9814,15,0.15284287752190748,0.1917918641335316,4066,5748,1.0,,0.0,,2,13,11,18570,2548
2020-07-25,S92000003,Scotland,3,18573,339.7914379802415,1.8660812294182216,1,2549,46.63373582144164,1598,272242,4980.643980973289,4383,5,0.11407711613050422,0.1757858457790635,2570,1813,4.0,,1.0,,1,4,3,18573,2549
2020-07-26,S92000003,Scotland,7,18580,339.9195023783388,1.68313208927918,0,2549,46.63373582144164,1572,273814,5009.403585803147,4176,8,0.1915708812260536,0.16304197640036475,2725,1451,0.0,,0.0,,1,7,7,18580,2549
2020-07-27,S92000003,Scotland,13,18593,340.1573362605196,1.68313208927918,0,2549,46.63373582144164,3084,276898,5065.825100622027,10710,16,0.14939309056956115,0.16227461858529818,5064,5646,4.0,,0.0,,2,14,13,18593,2549
2020-07-28,S92000003,Scotland,22,18615,340.55982436882545,1.7380168313208928,0,2549,46.63373582144164,3155,280053,5123.545554335895,15975,26,0.16275430359937404,0.1656853347939203,4945,11030,0.0,,0.0,,3,23,22,18615,2549
2020-07-29,S92000003,Scotland,28,18643,341.07208196121485,1.9575557994877424,0,2549,46.63373582144164,3080,283133,5179.8938894987205,15845,38,0.2398232881035027,0.1817047704282266,4290,11555,4.0,,0.0,,4,34,28,18643,2549
2020-07-30,S92000003,Scotland,27,18670,341.5660446395902,2.0307354555433594,0,2549,46.63373582144164,2941,286074,5233.699231613612,13415,32,0.23853894893775626,0.18837966576065016,4485,8930,4.0,,0.0,,3,29,27,18670,2549
2020-07-31,S92000003,Scotland,21,18691,341.95023783388217,2.2136845956824005,0,2549,46.63373582144164,2715,288789,5283.369923161361,9743,23,0.23606691983988504,0.19933465325198324,3980,5763,4.0,,0.0,,2,21,21,18691,2549
2020-08-01,S92000003,Scotland,22,18713,342.35272594218804,2.56128796194658,0,2549,46.63373582144164,1793,290582,5316.172703988293,4874,26,0.5334427574887156,0.2261232572453103,2692,2182,1.0,,0.0,,4,22,22,18713,2549
2020-08-02,S92000003,Scotland,19,18732,342.70032930845224,2.7808269301134283,0,2549,46.63373582144164,2074,292656,5354.116355653128,4773,19,0.3980724910957469,0.238932766974182,2673,2100,2.0,,0.0,,0,19,19,18732,2549
2020-08-03,S92000003,Scotland,60,18792,343.7980241492865,3.6406878887669234,0,2549,46.63373582144164,3642,296298,5420.746432491767,12024,70,0.5821689953426481,0.30528774021839816,4946,7078,3.0,,0.0,,8,62,60,18792,2549
2020-08-04,S92000003,Scotland,57,18849,344.84083424807915,4.281009879253569,0,2549,46.63373582144164,4398,300696,5501.207464324918,17849,63,0.35296095019328816,0.3451218114437808,4984,12865,6.0,,0.0,,6,57,57,18849,2549
2020-08-05,S92000003,Scotland,64,18913,346.01170874496887,4.939626783754116,0,2549,46.63373582144164,4610,305306,5585.547017929016,18447,73,0.3957283027050469,0.37719568567026207,4900,13547,6.0,,0.0,,8,65,64,18913,2549
2020-08-06,S92000003,Scotland,62,18975,347.1459934138311,5.579948774240762,0,2549,46.63373582144164,4091,309397,5660.391511159897,15929,73,0.4582836336242074,0.41487822666459423,4287,11642,2.0,,0.0,,7,66,62,18975,2549
2020-08-07,S92000003,Scotland,46,19021,347.9875594584705,6.0373216245883645,0,2549,46.63373582144164,3839,313236,5730.625686059276,12175,50,0.4106776180698152,0.4345249851866483,4445,7730,3.0,,0.0,,3,47,46,19021,2549
2020-08-08,S92000003,Scotland,27,19048,348.481522136846,6.128796194657888,0,2549,46.63373582144164,2237,315473,5771.551408708379,5591,28,0.5008048649615454,0.4332396183804213,2727,2864,3.0,,0.0,,4,24,27,19048,2549
2020-08-09,S92000003,Scotland,26,19074,348.9571899012075,6.256860592755214,0,2549,46.63373582144164,1857,317330,5805.525064032198,4702,36,0.7656316461080391,0.4531983348132431,2645,2057,2.0,,0.0,,3,33,26,19074,2549
2020-08-10,S92000003,Scotland,57,19131,350.0,6.201975850713503,0,2549,46.63373582144164,4349,321679,5885.0896450786695,13694,64,0.4673579669928435,0.4378471947232059,5431,8263,8.0,,0.0,,9,55,57,19131,2549
2020-08-11,S92000003,Scotland,64,19195,351.1708744968899,6.330040248810831,0,2549,46.63373582144164,4136,325815,5960.757409440174,18228,77,0.4224270353302612,0.4517495437442264,5151,13077,3.0,,0.0,,6,71,64,19195,2549
2020-08-12,S92000003,Scotland,48,19243,352.04903036955733,6.0373216245883645,0,2549,46.63373582144164,3629,329444,6027.149652396633,16788,57,0.3395282344531808,0.4419851447070844,4538,12250,2.0,,0.0,,3,54,48,19243,2549
2020-08-13,S92000003,Scotland,52,19295,353.0003658982804,5.854372484449322,0,2549,46.63373582144164,3463,332907,6090.504939626783,15116,72,0.4763164858428155,0.4449903817183118,4546,10570,3.0,,0.0,,9,63,52,19295,2549
2020-08-14,S92000003,Scotland,50,19345,353.9151115989755,5.9275521405049405,0,2549,46.63373582144164,3824,336731,6160.464690815953,12294,62,0.5043110460387179,0.45826438151667,4548,7746,7.0,,0.0,,7,55,50,19345,2549
2020-08-15,S92000003,Scotland,20,19365,354.2810098792536,5.79948774240761,0,2549,46.63373582144164,2493,339224,6206.073911452616,6163,30,0.4867759208177835,0.4575501523251135,2893,3270,7.0,,1.0,,4,26,20,19365,2549
2020-08-16,S92000003,Scotland,30,19395,354.8298572996707,5.872667398463228,0,2549,46.63373582144164,2578,341802,6253.238199780461,5861,37,0.6312915884661321,0.4526683608640407,2749,3112,2.0,,0.0,,3,34,30,19395,2549
2020-08-17,S92000003,Scotland,72,19467,356.1470911086718,6.1470911086717885,0,2549,46.63373582144164,5804,347606,6359.421880717161,15881,85,0.5352307789182041,0.4649566593971062,5319,10562,8.0,,0.0,,7,78,72,19467,2549
2020-08-18,S92000003,Scotland,77,19544,357.5557994877424,6.384924990852543,0,2549,46.63373582144164,6270,353876,6474.130991584339,21854,87,0.3980964583142674,0.45765616186127706,5804,16050,7.0,,0.0,,6,81,77,19544,2549
2020-08-19,S92000003,Scotland,91,19635,359.22063666300767,7.171606293450421,1,2550,46.65203073545554,6274,360150,6588.913282107575,21442,99,0.4617106613189068,0.4786484266461145,4896,16546,8.0,,0.0,,5,94,91,19635,2550
2020-08-20,S92000003,Scotland,140,19775,361.78192462495423,8.781558726673985,0,2550,46.65203073545554,7196,367346,6720.563483351629,20593,153,0.7429709124459768,0.5312812235800477,4746,15847,8.0,,0.0,,10,143,140,19775,2550
2020-08-21,S92000003,Scotland,90,19865,363.42846688620557,9.513355287230151,0,2550,46.65203073545554,7812,375158,6863.483351628247,18163,106,0.5836040301712272,0.5429395127186082,5027,13136,4.0,,0.0,,13,93,90,19865,2550
2020-08-22,S92000003,Scotland,47,19912,364.28832784485917,10.007317965605562,1,2551,46.67032564946946,5757,380915,6968.807171606291,10870,59,0.5427782888684453,0.5459429289053234,3177,7693,6.0,,0.0,,8,51,47,19912,2551
2020-08-23,S92000003,Scotland,65,19977,365.47749725576284,10.647639956092208,1,2552,46.68862056348336,6458,387373,7086.955726308086,11421,81,0.7092198581560284,0.5572930529677934,3133,8288,1.0,,0.0,,5,76,65,19977,2552
2020-08-24,S92000003,Scotland,60,20037,366.5751920965972,10.428100987925355,0,2552,46.68862056348336,12151,399524,7309.257226491035,24880,72,0.2893890675241157,0.5084234230748396,6090,18790,10.0,,1.0,,10,62,60,20037,2552
2020-08-25,S92000003,Scotland,69,20106,367.8375411635565,10.281741675814123,0,2552,46.68862056348336,11516,411040,7519.941456275156,29447,87,0.2954460556253608,0.480206993334113,6029,23418,11.0,,0.0,,13,74,69,20106,2552
2020-08-26,S92000003,Scotland,97,20203,369.6121478229052,10.391511159897547,0,2552,46.68862056348336,12335,423375,7745.609220636664,30096,113,0.37546517809675706,0.4612634907541073,5799,24297,12.0,,0.0,,8,105,97,20203,2552
2020-08-27,S92000003,Scotland,99,20302,371.42334431028166,9.641419685327481,0,2552,46.68862056348336,11757,435132,7960.702524698134,24210,109,0.45022717885171415,0.4205598073608027,5204,19006,10.0,,1.0,,9,100,99,20302,2552
2020-08-28,S92000003,Scotland,104,20406,373.3260153677278,9.897548481522136,1,2553,46.706915477497255,10175,445307,8146.85327478961,21537,116,0.5386079769698658,0.41781176825548827,5054,16483,5.0,,1.0,,20,96,104,20406,2553
2020-08-29,S92000003,Scotland,95,20501,375.0640321990488,10.775704354189537,0,2553,46.706915477497255,6135,451442,8259.09257226491,11241,110,0.9785606262788008,0.4501675041876047,3176,8065,4.0,,0.0,,7,103,95,20501,2553
2020-08-30,S92000003,Scotland,102,20603,376.9301134284669,11.452616172703989,0,2553,46.706915477497255,5859,457301,8366.282473472374,10866,113,1.0399411006810233,0.4728225536358085,3242,7624,3.0,,0.0,,10,103,102,20603,2553
2020-08-31,S92000003,Scotland,144,20747,379.56458104646913,12.989388949871936,0,2553,46.706915477497255,10478,467779,8557.976582510062,23254,155,0.6665519910553024,0.5330200264186763,6430,16824,4.0,,1.0,,15,140,144,20747,2553
2020-09-01,S92000003,Scotland,199,20946,383.20526893523595,15.367727771679473,0,2553,46.706915477497255,10296,478075,8746.341017197221,27409,214,0.7807654420080995,0.6257864386022758,6400,21009,4.0,,0.0,,34,180,199,20946,2553
2020-09-02,S92000003,Scotland,191,21137,386.6995975118917,17.087449688986467,1,2554,46.725210391511155,9792,487867,8925.484815221369,26178,203,0.7754603101841241,0.7049310618888005,5222,20956,9.0,,0.0,,12,191,191,21137,2554
2020-09-03,S92000003,Scotland,200,21337,390.35858031467245,18.93523600439078,1,2555,46.743505305525076,8552,496419,9081.942919868276,22294,219,0.9823270835202296,0.7914329138038507,5323,16971,4.0,,0.0,,13,206,200,21337,2555
2020-09-04,S92000003,Scotland,171,21508,393.4870106110502,20.16099524332236,1,2556,46.76180021953896,7068,503487,9211.251372118551,17487,195,1.1151140847486705,0.8714832515191488,5119,12368,17.0,,0.0,,22,173,171,21508,2556
2020-09-05,S92000003,Scotland,136,21644,395.97511891694114,20.911086717892424,0,2556,46.76180021953896,4479,507966,9293.194291986827,9327,148,1.5867910367749545,0.9114497679348024,3353,5974,9.0,,0.0,,8,140,136,21644,2556
2020-09-06,S92000003,Scotland,153,21797,398.7742407610685,21.844127332601534,0,2556,46.76180021953896,3808,511774,9362.861324551774,8054,165,2.0486714675937425,0.9693812825086006,3073,4981,8.0,,1.0,,10,155,153,21797,2556
2020-09-07,S92000003,Scotland,167,21964,401.8294914013904,22.264910354921327,0,2556,46.76180021953896,7809,519583,9505.726308086352,16543,198,1.1968808559511577,1.0542689249913584,6273,10270,16.0,,0.0,,35,163,167,21964,2556
2020-09-08,S92000003,Scotland,102,22066,403.6955726308087,20.490303695572628,0,2556,46.76180021953896,5192,524775,9600.713501646542,20278,115,0.5671170726896144,1.0344454523514286,6088,14190,14.0,,0.0,,21,94,102,22066,2556
2020-09-09,S92000003,Scotland,222,22288,407.75704354189537,21.057446030003657,0,2556,46.76180021953896,6302,531077,9716.008049762166,22641,243,1.0732741486683448,1.100116614076005,5607,17034,9.0,,1.0,,18,225,222,22288,2556
2020-09-10,S92000003,Scotland,216,22504,411.7087449688986,21.350164654226123,0,2556,46.76180021953896,5522,536599,9817.032564946945,18645,262,1.4052024671493697,1.1737109980084088,5566,13079,20.0,,1.0,,31,231,216,22504,2556
2020-09-11,S92000003,Scotland,209,22713,415.53238199780463,22.04537138675448,0,2556,46.76180021953896,4603,541202,9901.244054152945,14282,243,1.7014423750175045,1.2517081169718502,5364,8918,20.0,,1.0,,25,218,209,22713,2556
2020-09-12,S92000003,Scotland,207,22920,419.31942919868277,23.34431028174168,0,2556,46.76180021953896,3454,544656,9964.43468715697,8131,236,2.902472020661665,1.3465470554644758,3338,4793,16.0,,1.0,,23,213,207,22920,2556
2020-09-13,S92000003,Scotland,166,23086,422.35638492499083,23.58214416392243,1,2557,46.780095133552884,3353,548009,10025.77753384559,7300,191,2.6164383561643842,1.3800779076238174,3095,4205,12.0,,0.0,,11,180,166,23086,2557
2020-09-14,S92000003,Scotland,177,23263,425.5945847054519,23.765093304061473,3,2560,46.83497987559458,5319,553328,10123.088181485547,17016,199,1.1694875411377526,1.3749734516543082,6406,10610,19.0,,0.0,,38,161,177,23263,2560
2020-09-15,S92000003,Scotland,227,23490,429.7475301866081,26.05195755579949,0,2560,46.83497987559458,4891,558219,10212.568605927552,21047,258,1.2258279089656483,1.4963965450844474,6626,14421,20.0,,0.0,,33,225,227,23490,2560
2020-09-16,S92000003,Scotland,268,23758,434.6505671423345,26.893523600439078,0,2560,46.83497987559458,4376,562595,10292.627149652397,20120,305,1.5159045725646123,1.5899982166489894,5717,14403,34.0,,1.0,,45,260,268,23758,2560
2020-09-17,S92000003,Scotland,254,24012,439.297475301866,27.588730332967444,1,2561,46.85327478960848,4069,566664,10367.069154774974,15935,296,1.8575462817696893,1.6642428561797535,5215,10720,21.0,,1.0,,36,260,254,24012,2561
2020-09-18,S92000003,Scotland,269,24281,444.2188071716063,28.686425173801684,2,2563,46.8898646176363,3804,570468,10436.663007683863,13006,301,2.3143164693218514,1.7415045585295694,5351,7655,14.0,,3.0,,30,271,269,24281,2563
2020-09-19,S92000003,Scotland,232,24513,448.463227222832,29.14379802414929,0,2563,46.8898646176363,2627,573095,10484.72374679839,6881,258,3.749455021072518,1.7847095404965203,3217,3664,19.0,,0.0,,29,229,232,24513,2563
2020-09-20,S92000003,Scotland,315,24828,454.2261251372119,31.869740212221004,3,2566,46.94474935967801,2902,575997,10537.81558726674,7261,343,4.7238672359179175,1.935496612880928,3275,3986,19.0,,2.0,,31,312,315,24828,2566
2020-09-21,S92000003,Scotland,454,25282,462.53201609952436,36.937431394072455,2,2568,46.981339187705814,4787,580784,10625.3933406513,16238,483,2.974504249291785,2.2331024599952234,6110,10128,28.0,,0.0,,76,407,454,25282,2568
2020-09-22,S92000003,Scotland,493,25775,471.55140870837914,41.80387852177096,2,2570,47.017929015733614,4739,585523,10712.09293816319,22076,529,2.3962674397535784,2.477417575381464,6624,15452,33.0,,1.0,,84,445,493,25775,2570
2020-09-23,S92000003,Scotland,567,26342,481.9246249542627,47.27405781192828,2,2572,47.054518843761436,4854,590377,10800.896450786682,21371,595,2.78414674091058,2.7294488556749186,5744,15627,27.0,,3.0,,72,523,567,26342,2572
2020-09-24,S92000003,Scotland,715,27057,495.0054884742041,55.708013172338106,2,2574,47.09110867178924,4528,594905,10883.73582144164,18064,741,4.102081488042515,3.098277357789069,5501,12563,35.0,,1.0,,55,686,715,27057,2574
2020-09-25,S92000003,Scotland,577,27634,505.5616538602269,61.34284668862057,1,2575,47.109403585803136,4019,598924,10957.26308086352,13717,619,4.512648538310126,3.3785319293992884,4972,8745,35.0,,1.0,,59,560,577,27634,2575
2020-09-26,S92000003,Scotland,434,28068,513.5016465422613,65.03841931942921,2,2577,47.14599341383096,2964,601888,11011.489206000733,7934,474,5.974287874968492,3.5476884709500194,3477,4457,34.0,,3.0,,50,424,434,28068,2577
2020-09-27,S92000003,Scotland,357,28425,520.032930845225,65.80680570801317,2,2579,47.18258324185876,2804,604692,11062.78814489572,7224,401,5.55094130675526,3.6033163265306123,3411,3813,34.0,,2.0,,54,347,357,28425,2579
2020-09-28,S92000003,Scotland,624,29049,531.4489571899012,68.91694109037688,3,2582,47.23746798390048,4520,609212,11145.481156238568,16211,677,4.176176670162236,3.7862228768164212,5511,10700,45.0,,3.0,,99,578,624,29049,2582
2020-09-29,S92000003,Scotland,659,29708,543.505305525064,71.95389681668495,1,2583,47.25576289791438,4994,614206,11236.845956824003,23162,704,3.0394611864260423,3.9105522691604064,6924,16238,33.0,,2.0,,82,622,659,29708,2583
2020-09-30,S92000003,Scotland,794,30502,558.0314672521039,76.10684229784121,4,2587,47.32894255397,4697,618903,11322.77716794731,21769,846,3.8862602783775095,4.128385192587041,6095,15674,47.0,,4.0,,94,752,794,30502,2587
2020-10-01,S92000003,Scotland,778,31280,572.2649103549213,77.25942188071717,5,2592,47.420417124039524,4440,623343,11404.006586169044,19123,839,4.387386916278826,4.178119846069269,6195,12928,64.0,,2.0,,130,709,778,31280,2592
2020-10-02,S92000003,Scotland,817,32097,587.2118551042812,81.65020124405416,1,2593,47.43871203805342,4681,628024,11489.64507866813,15671,889,5.67289898538702,4.3476695411093305,5699,9972,54.0,,7.0,,113,776,817,32097,2593
2020-10-03,S92000003,Scotland,695,32792,599.9268203439442,86.42517380168312,3,2596,47.49359678009513,3675,631699,11556.878887669229,9717,771,7.934547699907379,4.542112210636357,3826,5891,46.0,,3.0,,85,686,695,32792,2596
2020-10-04,S92000003,Scotland,741,33533,613.4833516282472,93.45042078302231,3,2599,47.54848152213685,3842,635541,11627.167947310647,9788,788,8.05067429505517,4.776465900330039,3634,6154,46.0,,1.0,,83,705,741,33533,2599
2020-10-05,S92000003,Scotland,1098,34631,633.571167215514,102.12221002561287,2,2601,47.585071350164654,6542,642083,11746.853274789606,21043,1182,5.617069809437819,5.004448213647287,7382,13661,73.0,,3.0,,168,1014,1098,34631,2601
2020-10-06,S92000003,Scotland,1189,35820,655.3238199780461,111.81851445298209,4,2605,47.65825100622028,6033,648116,11857.226491035493,25363,1267,4.995465836060403,5.374201871417606,7425,17938,94.0,,0.0,,229,1038,1189,35820,2605
2020-10-07,S92000003,Scotland,1251,37071,678.2107574094402,120.17929015733624,9,2614,47.82290523234541,5993,654109,11966.86791072082,24646,1332,5.404528118153047,5.638566904133192,6739,17907,88.0,,5.0,,191,1141,1251,37071,2614
2020-10-08,S92000003,Scotland,1170,38241,699.6158068057083,127.35089645078669,11,2625,48.02414928649836,5653,659762,12070.289059641422,21448,1258,5.865348750466244,5.864062157335756,6489,14959,96.0,,3.0,,174,1084,1170,38241,2625
2020-10-09,S92000003,Scotland,1095,39336,719.6487376509331,132.436882546652,6,2631,48.13391877058178,5407,665169,12169.2096597146,16921,1190,7.03268128361208,6.040674495447003,5794,11127,81.0,,5.0,,215,975,1095,39336,2631
2020-10-10,S92000003,Scotland,938,40274,736.8093669959752,136.88254665203073,11,2642,48.33516282473472,3547,668716,12234.101719721917,9886,1043,10.55027311349383,6.243464115573803,3664,6222,75.0,,5.0,,153,890,938,40274,2642
2020-10-11,S92000003,Scotland,957,41231,754.3175997072814,140.834248079034,11,2653,48.53640687888768,3443,672159,12297.09110867179,9366,1053,11.242793081358103,6.4698887878575935,3332,6034,80.0,,4.0,,162,891,957,41231,2653
2020-10-12,S92000003,Scotland,1352,42583,779.0523234540798,145.4811562385657,8,2661,48.6827661909989,5932,678091,12405.616538602268,20839,1508,7.236431690580162,6.733920245351019,6905,13934,107.0,,9.0,,201,1307,1352,42583,2661
2020-10-13,S92000003,Scotland,1420,44003,805.0311013538237,149.70728137577748,12,2673,48.902305159165756,5751,683842,12510.830589096233,24920,1561,6.2640449438202275,6.986862043647384,7425,17495,124.0,,9.0,,256,1305,1420,44003,2673
2020-10-14,S92000003,Scotland,1288,45291,828.5949506037323,150.38419319429198,6,2679,49.01207464324918,5561,689403,12612.568605927549,23677,1419,5.993157916965831,7.108620540387385,6290,17387,123.0,,5.0,,227,1192,1288,45291,2679
2020-10-15,S92000003,Scotland,1292,46583,852.2319795096962,152.6161727039883,16,2695,49.304793267471645,5088,694491,12705.653128430295,20280,1439,7.095660749506902,7.318351881419345,6342,13938,107.0,,11.0,,246,1193,1292,46583,2695
2020-10-16,S92000003,Scotland,1250,47833,875.1006220270766,155.45188437614343,20,2715,49.670691547749726,4863,699354,12794.621295279912,16076,1388,8.633988554366757,7.526150794920187,5545,10531,140.0,,8.0,,238,1150,1250,47833,2715
2020-10-17,S92000003,Scotland,854,48687,890.7244785949507,153.91511159897547,10,2725,49.853640687888756,3153,702507,12852.305159165751,8594,970,11.28694437979986,7.545736634559442,3198,5396,88.0,,3.0,,160,810,854,48687,2725
2020-10-18,S92000003,Scotland,832,49519,905.9458470545187,151.62824734723748,22,2747,50.25612879619466,2648,705155,12900.750091474569,7674,925,12.053687776909044,7.545469441258397,3193,4481,88.0,,7.0,,172,753,832,49519,2747
2020-10-19,S92000003,Scotland,1354,50873,930.7171606293448,151.66483717526526,16,2763,50.54884742041714,5343,710498,12998.499817050859,19880,1535,7.721327967806841,7.627517526692594,6948,12932,140.0,,12.0,,294,1241,1354,50873,2763
2020-10-20,S92000003,Scotland,1688,52561,961.5989754848152,156.56787413099158,19,2782,50.89645078668131,6012,716510,13108.488840102451,26283,1856,7.061598752045048,7.783511889208258,7976,18307,138.0,,3.0,,319,1537,1688,52561,2782
2020-10-21,S92000003,Scotland,1578,54139,990.468349798756,161.87339919502378,11,2793,51.097694840834244,5563,722073,13210.263446761799,23938,1728,7.2186481744506645,8.018741087797924,6335,17603,132.0,,8.0,,305,1423,1578,54139,2793
2020-10-22,S92000003,Scotland,1491,55630,1017.7460665934873,165.51408708379068,17,2810,51.4087083790706,5208,727281,13305.543358946212,20910,1661,7.943567670970827,8.157756069879616,6592,14318,136.0,,9.0,,345,1316,1491,55630,2810
2020-10-23,S92000003,Scotland,1280,56910,1041.1635565312843,166.06293450420782,18,2828,51.7380168313209,4933,732214,13395.792169776802,17200,1420,8.255813953488373,8.109801653290917,6182,11018,131.0,,7.0,,262,1158,1280,56910,2828
2020-10-24,S92000003,Scotland,948,57858,1058.5071350164653,167.78265642151482,20,2848,52.10391511159898,3388,735602,13457.775338455913,9886,1102,11.147076674084566,8.131445245724372,3774,6112,119.0,,9.0,,203,899,948,57858,2848
2020-10-25,S92000003,Scotland,937,58795,1075.6494694474936,169.70362239297475,23,2871,52.52469813391877,3234,738836,13516.941090376875,9034,1067,11.810936462253707,8.156153888508703,3557,5477,115.0,,10.0,,237,830,937,58795,2871
2020-10-26,S92000003,Scotland,1344,60139,1100.237833882181,169.5206732528357,31,2902,53.0918404683498,5959,744795,13625.96048298573,22064,1515,6.866388687454678,8.002938560878475,7976,14088,139.0,,9.0,,312,1203,1344,60139,2902
2020-10-27,S92000003,Scotland,1301,61440,1124.0395170142701,162.4405415294548,16,2918,53.38455909257227,5256,750051,13722.118551042813,24871,1481,5.95472638816292,7.798096995379312,8185,16686,138.0,,8.0,,393,1088,1301,61440,2918
2020-10-28,S92000003,Scotland,1265,62705,1147.1825832418588,156.7142334431028,29,2947,53.91511159897549,4754,754805,13809.092572264912,23407,1458,6.228905882855557,7.618628898030964,7050,16357,131.0,,2.0,,347,1111,1265,62705,2947
2020-10-29,S92000003,Scotland,1096,63801,1167.2338090010976,149.48774240761068,29,2976,54.445664105378704,4462,759267,13890.724478594952,19969,1271,6.364865541589464,7.3668641393329155,6949,13020,103.0,,7.0,,276,995,1096,63801,2976
2020-10-30,S92000003,Scotland,1089,64890,1187.1569703622392,145.993413830955,35,3011,55.085986095865344,4204,763471,13967.636297109404,16070,1252,7.790914747977598,7.2992234698845175,6474,9596,132.0,,10.0,,276,976,1089,64890,3011
2020-10-31,S92000003,Scotland,741,65631,1200.7135016465422,142.20636663007684,24,3035,55.52506403219905,2729,766200,14017.563117453346,8474,857,10.113287703563842,7.1846572334912695,3877,4597,105.0,,5.0,,224,633,741,65631,3035
2020-11-01,S92000003,Scotland,969,66600,1218.4412733260153,142.7918038785217,35,3070,56.1653860226857,3110,769310,14074.460300036591,8813,1126,12.776580052195618,7.2452049034511745,3521,5292,105.0,,11.0,,249,877,969,66600,3070
2020-11-02,S92000003,Scotland,1474,68074,1245.4079765825102,145.1701427003293,29,3099,56.6959385290889,6212,775522,14188.108305890964,22717,1673,7.364528767002685,7.334239589449892,8075,14642,113.0,,8.0,,362,1311,1474,68074,3099
2020-11-03,S92000003,Scotland,1388,69462,1270.801317233809,146.76180021953897,35,3134,57.33626051957557,5849,781371,14295.115257958289,26746,1614,6.034547222014506,7.3306602427969185,8631,18115,118.0,,13.0,,419,1195,1388,69462,3134
2020-11-04,S92000003,Scotland,1300,70762,1294.5847054518845,147.40212221002562,19,3153,57.68386388583974,5440,786811,14394.639590193923,25003,1494,5.975282966044074,7.2672780768749226,7741,17262,125.0,,5.0,,311,1183,1300,70762,3153
2020-11-05,S92000003,Scotland,1290,72052,1318.1851445298207,150.95133552872298,41,3194,58.43395536040981,5308,792119,14491.748993779729,22018,1521,6.907984376419293,7.345137514344468,7500,14518,101.0,,6.0,,366,1155,1290,72052,3194
2020-11-06,S92000003,Scotland,1131,73183,1338.8766922795462,151.719721917307,27,3221,58.92791803878522,5009,797128,14583.388218075374,18124,1334,7.3604060913705585,7.292922400394253,7143,10981,99.0,,7.0,,294,1040,1131,73183,3221
2020-11-07,S92000003,Scotland,837,74020,1354.189535309184,153.47603366264178,37,3258,59.60482985729967,3377,800505,14645.170142700326,9826,976,9.932831263993489,7.308232080271976,4004,5822,88.0,,5.0,,193,783,837,74020,3258
2020-11-08,S92000003,Scotland,873,74893,1370.1609952433225,151.719721917307,36,3294,60.263446761800225,3003,803508,14700.109769484085,9076,1001,11.029087703834287,7.200209722118193,3693,5383,82.0,,7.0,,233,768,873,74893,3294
2020-11-09,S92000003,Scotland,1295,76188,1393.8529088913285,148.44493230881815,42,3336,61.03183315038421,6048,809556,14810.757409440175,22873,1492,6.522974686311371,7.056394296230904,8647,14226,103.0,,4.0,,409,1083,1295,76188,3336
2020-11-10,S92000003,Scotland,1285,77473,1417.361873399195,146.560556165386,36,3372,61.69045005488474,5577,815133,14912.788144895718,26678,1448,5.4276932303770895,6.935732570846867,9122,17556,107.0,,5.0,,329,1119,1285,77473,3372
2020-11-11,S92000003,Scotland,1246,78719,1440.1573362605195,145.5726308086352,37,3409,62.36736187339919,5346,820479,15010.592755214053,25377,1438,5.666548449383299,6.874570805840026,8691,16686,115.0,,9.0,,339,1099,1246,78719,3409
2020-11-12,S92000003,Scotland,1194,79913,1462.0014635931213,143.8163190633004,32,3441,62.95279912184412,4988,825467,15101.847786315402,21064,1358,6.447018609950626,6.801335157647836,7519,13545,112.0,,8.0,,304,1054,1194,79913,3441
2020-11-13,S92000003,Scotland,1053,80966,1481.266008049762,142.38931577021592,38,3479,63.64800585437247,5023,830490,15193.743139407243,17599,1254,7.12540485254844,6.767904719494616,6972,10627,109.0,,6.0,,273,981,1053,80966,3479
2020-11-14,S92000003,Scotland,903,81869,1497.7863154043175,143.59678009513354,41,3520,64.39809732894254,4043,834533,15267.70947676546,11557,1079,9.336332958380202,6.757360829657885,4383,7174,100.0,,11.0,,253,826,903,81869,3520
2020-11-15,S92000003,Scotland,812,82681,1512.6417855836078,142.4807903402854,34,3554,65.0201244054153,3489,838022,15331.540431759973,9943,963,9.685205672332293,6.6858636030527565,3881,6062,95.0,,8.0,,219,744,812,82681,3554
2020-11-16,S92000003,Scotland,1273,83954,1535.9312111233075,142.0783022319795,33,3587,65.62385656787414,6332,844354,15447.383827296013,23803,1473,6.188295592992481,6.626182721785606,9097,14706,95.0,,6.0,,379,1094,1273,83954,3587
2020-11-17,S92000003,Scotland,1224,85178,1558.3241858763265,140.96231247713138,36,3623,66.28247347237468,6367,850721,15563.867544822542,28538,1429,5.007358609573201,6.523016224135307,9916,18622,111.0,,4.0,,430,999,1224,85178,3623
2020-11-18,S92000003,Scotland,1110,86288,1578.63154043176,138.47420417124042,24,3647,66.72155140870838,5717,856438,15668.459568240027,25883,1276,4.929876753081173,6.382102365106548,9118,16765,97.0,,8.0,,305,971,1110,86288,3647
2020-11-19,S92000003,Scotland,980,87268,1596.560556165386,134.55909257226492,25,3672,67.17892425905599,4941,861379,15758.854738382732,20409,1172,5.742564554853251,6.277408300177156,7062,13347,97.0,,5.0,,320,852,980,87268,3672
2020-11-20,S92000003,Scotland,858,88126,1612.2575923893155,130.99158433955358,29,3701,67.7094767654592,4514,865893,15841.437980241491,17432,1049,6.0176686553464895,6.136008432377423,7190,10242,110.0,,10.0,,292,757,858,88126,3701
2020-11-21,S92000003,Scotland,762,88888,1626.1983168679105,128.41200146359313,33,3734,68.31320892791804,3035,868928,15896.96304427369,10072,895,8.886020651310563,6.067754262198707,4001,6071,87.0,,4.0,,249,646,762,88888,3734
2020-11-22,S92000003,Scotland,706,89594,1639.1145261617264,126.4727405781193,36,3770,68.97182583241859,3015,871943,15952.122210025613,9112,865,9.492976294995607,6.0325769506613725,3682,5430,68.0,,2.0,,204,661,706,89594,3770
2020-11-23,S92000003,Scotland,1153,90747,1660.2085620197586,124.27735089645078,31,3801,69.53896816684961,5730,877673,16056.952067325283,22966,1381,6.013236958982843,6.001696277118115,9159,13807,107.0,,8.0,,346,1035,1153,90747,3801
2020-11-24,S92000003,Scotland,990,91737,1678.3205268935235,119.99634101719722,30,3831,70.08781558726673,5497,883170,16157.519209659717,26749,1171,4.377733747055965,5.888118953725973,9516,17233,105.0,,12.0,,326,845,990,91737,3831
2020-11-25,S92000003,Scotland,929,92666,1695.3165020124404,116.68496158068056,32,3863,70.67325283571166,4886,888056,16246.908159531653,24130,1095,4.537919602154994,5.828684954535035,8438,15692,86.0,,6.0,,250,845,929,92666,3863
2020-11-26,S92000003,Scotland,799,93465,1709.9341383095498,113.37358214416392,23,3886,71.09403585803149,5047,893103,16339.242590559825,20740,971,4.681774349083896,5.660780024542496,7523,13217,104.0,,8.0,,248,723,799,93465,3886
2020-11-27,S92000003,Scotland,735,94200,1723.3809001097693,111.12330772045372,24,3910,71.53311379436516,4807,897910,16427.186242224663,17188,911,5.300209448452408,5.565949128339836,7397,9791,92.0,,7.0,,259,652,735,94200,3910
2020-11-28,S92000003,Scotland,571,94771,1733.8272960117088,107.62897914379805,41,3951,72.28320526893525,3126,901036,16484.376143432124,9829,693,7.0505646556109465,5.421760484722372,4153,5676,63.0,,3.0,,161,532,571,94771,3951
2020-11-29,S92000003,Scotland,555,95326,1743.9809732894253,104.86644712769848,28,3979,72.79546286132455,2865,903901,16536.79107208196,8442,672,7.960199004975125,5.301282642797823,3559,4883,69.0,,4.0,,165,507,555,95326,3979
2020-11-30,S92000003,Scotland,972,96298,1761.7636297109402,101.55506769118185,32,4011,73.38090010976948,6814,910715,16661.452616172704,24479,1140,4.657052984190531,5.057123528204505,9481,14998,88.0,,6.0,,335,805,972,96298,4011
2020-12-01,S92000003,Scotland,923,97221,1778.649835345774,100.32930845225029,27,4038,73.87486278814491,6280,916995,16776.344676180022,27808,1089,3.9161392405063284,4.954907401821802,9650,18158,84.0,,6.0,,325,764,923,97221,4038
2020-12-02,S92000003,Scotland,948,98169,1795.9934138309552,100.67691181851448,20,4058,74.24076106842298,5972,922967,16885.601902671056,26054,1118,4.291087740845936,4.901144640998959,8905,17149,102.0,,5.0,,329,789,948,98169,4058
2020-12-03,S92000003,Scotland,803,98972,1810.68422978412,100.75009147457008,36,4094,74.89937797292353,5176,928143,16980.296377607032,20640,962,4.6608527131782935,4.898095804819994,7229,13411,75.0,,4.0,,251,711,803,98972,4094
2020-12-04,S92000003,Scotland,646,99618,1822.502744237102,99.1218441273326,29,4123,75.42993047932676,4635,932778,17065.093304061473,17262,792,4.588112617309697,4.806934594168637,7326,9936,86.0,,5.0,,230,562,646,99618,4123
2020-12-05,S92000003,Scotland,662,100280,1834.6139773143066,100.78668130259787,19,4142,75.77753384559092,3702,936480,17132.821075740943,10211,781,7.648614239545587,4.8585577037124885,3745,6466,78.0,,3.0,,176,605,662,100280,4142
2020-12-06,S92000003,Scotland,643,100923,1846.3776070252468,102.39663373582144,29,4171,76.30808635199415,3377,939857,17194.6030003659,9893,747,7.5507934903467095,4.861859813563921,4055,5838,66.0,,1.0,,180,567,643,100923,4171
2020-12-07,S92000003,Scotland,949,101872,1863.7394804244416,101.97585071350164,29,4200,76.83863885839736,6068,945925,17305.61653860227,24395,1104,4.525517524082804,4.838437433492585,10029,14366,92.0,,5.0,,303,801,949,101872,4200
2020-12-08,S92000003,Scotland,1040,102912,1882.7661909989026,104.11635565312841,28,4228,77.35089645078669,5677,951602,17409.476765459203,28025,1190,4.246208742194469,4.9047479484173495,10285,17740,105.0,,7.0,,326,864,1040,102912,4228
2020-12-09,S92000003,Scotland,996,103908,1900.9879253567508,104.99451152579584,23,4251,77.77167947310647,5097,956699,17502.72594218807,24867,1160,4.664816825511722,4.978823738109142,8734,16133,97.0,,3.0,,298,862,996,103908,4251
2020-12-10,S92000003,Scotland,891,104799,1917.2886937431397,106.60446395901936,23,4274,78.19246249542627,4462,961161,17584.357848518113,20203,1038,5.1378508142355095,5.051313994186392,7443,12760,94.0,,7.0,,274,764,891,104799,4274
2020-12-11,S92000003,Scotland,864,105663,1933.0954994511526,110.5927552140505,20,4294,78.55836077570436,4421,965582,17665.239663373584,17872,1015,5.679274843330349,5.1931850058317215,7699,10173,92.0,,5.0,,218,797,864,105663,4294
2020-12-12,S92000003,Scotland,677,106340,1945.4811562385653,110.86717892425906,23,4317,78.97914379802414,3268,968850,17725.027442371018,10120,772,7.628458498023716,5.190027700831025,4116,6004,69.0,,3.0,,131,641,677,106340,4317
2020-12-13,S92000003,Scotland,720,107060,1958.653494328577,112.2758873033297,26,4343,79.45481156238566,3244,972094,17784.376143432128,9838,824,8.375686115064036,5.24903931421815,3971,5867,70.0,,4.0,,177,647,720,107060,4343
2020-12-14,S92000003,Scotland,1083,108143,1978.4668862056349,114.7274057811928,31,4374,80.02195389681668,5613,977707,17887.06549579217,24158,1253,5.186687639705274,5.368551187047963,9888,14270,93.0,,6.0,,322,931,1083,108143,4374
2020-12-15,S92000003,Scotland,1033,109176,1997.3655323819974,114.59934138309549,32,4406,80.60739114526162,5495,983202,17987.596048298572,27802,1170,4.208330335947053,5.362598250037076,10007,17795,84.0,,8.0,,255,915,1033,109176,4406
2020-12-16,S92000003,Scotland,1028,110204,2016.172703988292,115.18477863154041,31,4437,81.17453347969264,5181,988383,18082.38199780461,24815,1176,4.7390691114245405,5.376535517179988,8679,16136,112.0,,6.0,,310,866,1028,110204,4437
2020-12-17,S92000003,Scotland,911,111115,2032.839370654958,115.55067691181853,36,4473,81.8331503841932,4866,993249,18171.405049396268,21198,1043,4.920275497688461,5.340824576776655,7618,13580,99.0,,5.0,,287,756,911,111115,4473
2020-12-18,S92000003,Scotland,920,112035,2049.67069154775,116.57519209659716,23,4496,82.25393340651299,5025,998274,18263.336992316134,18643,1064,5.707235959877702,5.346552052367215,7309,11334,88.0,,8.0,,275,789,920,112035,4496
2020-12-19,S92000003,Scotland,747,112782,2063.3369923161363,117.85583607757044,27,4523,82.74789608488841,3961,1002235,18335.80314672521,11629,888,7.6360822082724225,5.3721312543904745,4341,7288,94.0,,8.0,,234,654,747,112782,4523
2020-12-20,S92000003,Scotland,812,113594,2078.1924624954268,119.53896816684963,29,4552,83.27844859129162,4346,1006581,18415.312843029642,13112,950,7.245271507016474,5.336842179729338,4365,8747,70.0,,4.0,,201,749,812,113594,4552
2020-12-21,S92000003,Scotland,1304,114898,2102.049030369557,123.58214416392245,25,4577,83.73582144163923,6825,1013406,18540.17563117453,30734,1512,4.919632979761827,5.2746851615258254,11081,19653,107.0,,10.0,,390,1122,1304,114898,4577
2020-12-22,S92000003,Scotland,1326,116224,2126.308086351994,128.94255396999634,28,4605,84.24807903402855,6544,1019950,18659.89754848152,32415,1500,4.627487274409996,5.3315065619550825,9241,23174,105.0,,3.0,,303,1197,1326,116224,4605
2020-12-23,S92000003,Scotland,1313,117537,2150.32930845225,134.156604463959,35,4640,84.88840102451519,5784,1025734,18765.715331137944,27703,1504,5.429014908132694,5.4434679671114425,8336,19367,106.0,,6.0,,265,1239,1313,117537,4640
2020-12-24,S92000003,Scotland,1017,118554,2168.935236004391,136.09586534943284,36,4676,85.54701792901574,3328,1029062,18826.600804976217,13951,1140,8.171457243208371,5.775135470722804,4742,9209,95.0,,1.0,,205,935,1017,118554,4676
2020-12-25,S92000003,Scotland,515,119069,2178.3571167215514,128.6864251738017,35,4711,86.18733991950238,1186,1030248,18848.298572996708,4510,598,13.259423503325946,6.036373401763469,2367,2143,78.0,,5.0,,122,476,515,119069,4711
2020-12-26,S92000003,Scotland,1050,120119,2197.566776436151,134.22978412001464,34,4745,86.80936699597513,2618,1032866,18896.194657885106,8945,1176,13.147009502515376,6.378929740427799,3905,5040,109.0,,7.0,,230,946,1050,120119,4745
2020-12-27,S92000003,Scotland,1681,121800,2228.3205268935235,150.12806439809734,34,4779,87.43139407244786,3696,1036562,18963.812660080497,13378,1867,13.955748243384662,7.062657631650916,5066,8312,142.0,,8.0,,287,1580,1681,121800,4779
2020-12-28,S92000003,Scotland,1804,123604,2261.324551774607,159.27552140504937,31,4810,87.99853640687887,3865,1040427,19034.52250274424,20659,1990,9.632605644029235,8.041230328806114,8654,12005,155.0,,11.0,,406,1584,1804,123604,4810
2020-12-29,S92000003,Scotland,3133,126737,2318.642517380168,192.33443102817418,26,4836,88.47420417124039,5778,1046205,19140.230515916577,35114,3356,9.557441476334226,9.360212457749881,10824,24290,156.0,,12.0,,466,2890,3133,126737,4836
2020-12-30,S92000003,Scotland,2963,129700,2372.850347603366,222.52103915111599,32,4868,89.05964141968529,6123,1052328,19252.25027442371,31401,3192,10.165281360466226,10.408884165116678,9704,21697,192.0,,7.0,,451,2741,2963,129700,4868
2020-12-31,S92000003,Scotland,2374,132074,2416.2824734723745,247.3472374679839,44,4912,89.86461763629711,5060,1057388,19344.822539334065,18720,2612,13.952991452991451,11.143927008069197,6167,12553,173.0,,9.0,,409,2203,2374,132074,4912
2021-01-01,S92000003,Scotland,1159,133233,2437.4862788144897,259.12916209293815,35,4947,90.50493962678377,2110,1059498,19383.4248079034,8394,1275,15.189421015010721,11.322660693501987,3714,4680,135.0,,14.0,,228,1047,1159,133233,4947
2021-01-02,S92000003,Scotland,2211,135444,2477.9363336992315,280.3695572630809,42,4989,91.27332601536772,4475,1063973,19465.294548115624,15245,2400,15.742866513611018,11.679996641266243,4824,10421,153.0,,9.0,,328,2072,2211,135444,4989
2021-01-03,S92000003,Scotland,2218,137662,2518.514452982071,290.19392608854736,42,5031,92.0417124039517,4961,1068934,19556.055616538604,17058,2390,14.01102122171415,11.743558608645825,6116,10942,137.0,,10.0,,393,1997,2218,137662,5031
2021-01-04,S92000003,Scotland,2376,140038,2561.983168679107,300.6586169045005,37,5068,92.71862422246616,5055,1073989,19648.536406878888,24450,2644,10.813905930470348,11.882406139032595,9175,15275,187.0,,12.0,,537,2107,2376,140038,5068
2021-01-05,S92000003,Scotland,3050,143088,2617.7826564215147,299.1401390413465,40,5108,93.45042078302231,7262,1081251,19781.39407244786,37296,3420,9.16988416988417,11.754411263469756,12055,25241,195.0,,17.0,,718,2702,3050,143088,5108
2021-01-06,S92000003,Scotland,2548,145636,2664.3980973289426,291.54774972557635,48,5156,94.32857665568972,6407,1087658,19898.60958653494,30395,2899,9.537752919888142,11.639108460127476,10813,19582,200.0,,13.0,,581,2318,2548,145636,5156
2021-01-07,S92000003,Scotland,2197,147833,2704.59202341749,288.3095499451153,44,5200,95.13355287230152,5965,1093623,20007.738748627882,25211,2646,10.495418666455118,11.182607925390228,9253,15958,204.0,,18.0,,774,1872,2197,147833,5200
2021-01-08,S92000003,Scotland,1823,149656,2737.943651664837,300.4573728503476,42,5242,95.90193926088548,5386,1099009,20106.275155506766,21495,2230,10.374505698999767,10.884604148407831,8920,12575,198.0,,11.0,,582,1648,1823,149656,5242
2021-01-09,S92000003,Scotland,1497,151153,2765.331137943652,287.39480424442,38,5280,96.59714599341385,3891,1102900,20177.460665934872,13711,1752,12.778061410546277,10.601004622205453,5538,8173,182.0,,21.0,,422,1330,1497,151153,5280
2021-01-10,S92000003,Scotland,1423,152576,2791.364800585437,272.8503476033664,59,5339,97.6765459202342,3664,1106564,20244.493230881817,13424,1662,12.380810488676994,10.394500608499717,6021,7403,168.0,,15.0,,444,1218,1423,152576,5339
2021-01-11,S92000003,Scotland,2087,154663,2829.546286132455,267.563117453348,48,5387,98.55470179290155,5890,1112454,20352.25027442371,29253,2381,8.139336136464637,9.948180460813305,12145,17108,241.0,,9.0,,606,1775,2087,154663,5387
2021-01-12,S92000003,Scotland,1977,156640,2865.715331137944,247.93267471642883,51,5438,99.48774240761068,4872,1117326,20441.383095499452,31065,2410,7.757926927410269,9.711097876684855,12951,18114,211.0,,16.0,,756,1654,1977,156640,5438
2021-01-13,S92000003,Scotland,1712,158352,2897.0362239297474,232.6381266008049,51,5489,100.4207830223198,4647,1121973,20526.399560922062,25123,2097,8.34693308920113,9.529011438831759,10533,14590,180.0,,16.0,,625,1472,1712,158352,5489
2021-01-14,S92000003,Scotland,1620,159972,2926.6739846322725,222.0819612147823,58,5547,101.48188803512623,4143,1126116,20602.195389681667,20739,1996,9.624379188967644,9.384406692074156,8608,12131,204.0,,19.0,,530,1466,1620,159972,5547
2021-01-15,S92000003,Scotland,1535,161507,2954.756677643615,216.81302597877792,58,5605,102.54299304793268,4588,1130704,20686.13245517746,20018,1820,9.091817364372066,9.207411320459393,9322,10696,184.0,,13.0,,472,1348,1535,161507,5605
2021-01-16,S92000003,Scotland,1176,162683,2976.271496523966,210.94035858031467,76,5681,103.93340651298941,3210,1133914,20744.85912916209,12466,1392,11.16637253329055,9.046078586081745,5858,6608,170.0,,17.0,,347,1045,1176,162683,5681
2021-01-17,S92000003,Scotland,1199,163882,2998.207098426637,206.84229784120015,43,5724,104.72008781558728,2801,1136715,20796.103183315037,11206,1446,12.903801534892025,9.03583105357977,5540,5666,160.0,,15.0,,410,1036,1199,163882,5724
2021-01-18,S92000003,Scotland,1735,165617,3029.948774240761,200.4024881083059,63,5787,105.87266739846321,5242,1141957,20892.005122575923,28889,2064,7.144587905431132,8.845798830816154,14622,14267,175.0,,19.0,,557,1507,1735,165617,5787
2021-01-19,S92000003,Scotland,1548,167165,3058.2693011342853,192.553969996341,70,5857,107.15331137943652,4992,1146949,20983.333333333336,30016,1831,6.100079957356077,8.518291491812443,14564,15452,197.0,,15.0,,517,1314,1548,167165,5857
2021-01-20,S92000003,Scotland,1572,168737,3087.028905964142,189.99268203439445,66,5923,108.36077570435421,4394,1151343,21063.721185510432,24796,1876,7.565736409098243,8.387902518058464,12386,12410,184.0,,17.0,,565,1311,1572,168737,5923
2021-01-21,S92000003,Scotland,1240,169977,3109.714599341383,183.04061470911088,57,5980,109.40358580314673,4364,1155707,21143.560190267104,21363,1598,7.480222815147686,8.085160735173508,10054,11309,194.0,,17.0,,538,1060,1240,169977,5980
2021-01-22,S92000003,Scotland,1228,171205,3132.1807537504574,177.4240761068423,68,6048,110.6476399560922,4110,1159817,21218.75228686425,18943,1470,7.760122472681202,7.907014538289127,9975,8968,171.0,,8.0,,434,1036,1228,171205,6048
2021-01-23,S92000003,Scotland,936,172141,3149.3047932674717,173.03329674350533,53,6101,111.61727039882912,3368,1163185,21280.369557263082,11624,1109,9.540605643496216,7.759624617773451,5070,6554,147.0,,7.0,,305,804,936,172141,6101
2021-01-24,S92000003,Scotland,857,172998,3164.9835345773877,166.7764361507501,70,6171,112.8979143798024,2947,1166132,21334.284668862056,10712,984,9.185959671396564,7.4701215637235805,5176,5536,119.0,,9.0,,253,731,857,172998,6171
2021-01-25,S92000003,Scotland,1318,174316,3189.096231247713,159.1474570069521,52,6223,113.84924990852542,4899,1171031,21423.91145261617,26507,1599,6.032368808239332,7.2707191531039665,15050,11457,148.0,,14.0,,502,1097,1318,174316,6223
2021-01-26,S92000003,Scotland,1178,175494,3210.647639956092,152.37833882180755,50,6273,114.76399560922064,4123,1175154,21499.3413830955,27252,1418,5.203287832085718,7.120547886994768,15829,11423,160.0,,6.0,,403,1015,1178,175494,6273
2021-01-27,S92000003,Scotland,1112,176606,3230.9915843395534,143.96267837541163,61,6334,115.8799853640688,4265,1179419,21577.3691913648,22619,1314,5.809275387948184,6.827794561933535,12422,10197,157.0,,13.0,,344,970,1112,176606,6334
2021-01-28,S92000003,Scotland,1113,177719,3251.3538236370287,141.63922429564582,46,6380,116.72155140870838,4462,1183881,21659.00109769484,21071,1310,6.2170756015376565,6.634565480652788,10328,10743,140.0,,8.0,,400,910,1113,177719,6380
2021-01-29,S92000003,Scotland,961,178680,3268.935236004391,136.75448225393342,59,6439,117.80095133552872,3945,1187826,21731.17453347969,17483,1159,6.629297031401932,6.478567473846781,9237,8246,152.0,,12.0,,324,835,961,178680,6439
2021-01-30,S92000003,Scotland,779,179459,3283.186974021222,133.88218075375045,44,6483,118.60592755214053,2808,1190634,21782.54665203073,10537,931,8.835531935085887,6.39957115897225,4880,5657,117.0,,9.0,,221,710,779,179459,6483
2021-01-31,S92000003,Scotland,809,180268,3297.9875594584705,133.00402488108307,48,6531,119.4840834248079,2432,1193066,21827.039882912548,9806,966,9.851111564348358,6.429125854740343,5019,4787,108.0,,12.0,,240,726,809,180268,6531
2021-02-01,S92000003,Scotland,1095,181363,3318.020490303696,128.92425905598245,43,6574,120.27076472740578,4173,1197239,21903.384559092567,24555,1302,5.302382406841784,6.300488287842307,15672,8883,123.0,,9.0,,325,977,1095,181363,6574
2021-02-02,S92000003,Scotland,1049,182412,3337.211855104281,126.56421514818881,44,6618,121.07574094401757,4005,1201244,21976.655689718256,27108,1246,4.5964290984211305,6.178151210025605,17207,9901,112.0,,11.0,,348,898,1049,182412,6618
2021-02-03,S92000003,Scotland,930,183342,3354.226125137212,123.23454079765823,48,6666,121.95389681668495,3668,1204912,22043.76143432126,21780,1107,5.082644628099174,6.060903732809429,13180,8600,111.0,,5.0,,281,826,930,183342,6666
2021-02-04,S92000003,Scotland,899,184241,3370.6732528357124,119.31942919868277,32,6698,122.5393340651299,3785,1208697,22113.00768386388,20882,1073,5.138396705296428,5.8902316289698895,11210,9672,111.0,,7.0,,273,800,899,184241,6698
2021-02-05,S92000003,Scotland,935,185176,3387.778997438712,118.8437614343213,44,6742,123.3443102817417,3626,1212323,22179.3450420783,17944,1081,6.024297815425769,5.810937170090188,9918,8026,114.0,,14.0,,291,790,935,185176,6742
2021-02-06,S92000003,Scotland,698,185874,3400.5488474204167,117.36187339919505,51,6793,124.27735089645078,2504,1214827,22225.155506769122,9856,805,8.167613636363637,5.745427534089791,4878,4978,92.0,,7.0,,154,651,698,185874,6793
2021-02-07,S92000003,Scotland,654,186528,3412.5137211855103,114.52616172703988,42,6835,125.04573728503479,2250,1217077,22266.3190633004,9200,780,8.478260869565217,5.6303064915286525,4908,4292,96.0,,10.0,,208,572,654,186528,6835
2021-02-08,S92000003,Scotland,991,187519,3430.643980973289,112.62349066959385,40,6875,125.77753384559091,3629,1220706,22332.71130625686,23519,1155,4.910923083464434,5.562250074833639,15665,7854,83.0,,15.0,,315,840,991,187519,6875
2021-02-09,S92000003,Scotland,758,188277,3444.5115257958287,107.29967069154776,49,6924,126.67398463227222,2796,1223502,22383.86388583973,21985,888,4.039117580168297,5.503890832973812,15756,6229,97.0,,9.0,,300,588,758,188277,6924
2021-02-10,S92000003,Scotland,845,189122,3459.9707281375777,105.7446030003659,37,6961,127.35089645078669,2817,1226319,22435.400658616905,18369,1006,5.476618215471718,5.575130384789126,11929,6440,80.0,,7.0,,326,680,845,189122,6961
2021-02-11,S92000003,Scotland,842,189964,3475.3750457372853,104.70179290157336,35,6996,127.99121844127329,3423,1229742,22498.0241492865,20219,1015,5.0200306642267165,5.557757737918277,11116,9103,95.0,,12.0,,331,684,842,189964,6996
2021-02-12,S92000003,Scotland,902,190866,3491.877058177827,104.09806073911452,41,7037,128.7413099158434,3607,1233349,22564.01390413465,17615,1027,5.830258302583027,5.528183301176685,9403,8212,94.0,,12.0,,283,744,902,190866,7037
2021-02-13,S92000003,Scotland,542,191408,3501.7929015733625,101.24405415294548,32,7069,129.32674716428832,2512,1235861,22609.970728137578,9783,641,6.5521823571501585,5.3956417267379235,4785,4998,70.0,,7.0,,154,487,542,191408,7069
2021-02-14,S92000003,Scotland,681,192089,3514.251738016831,101.73801683132088,32,7101,129.9121844127333,2221,1238082,22650.603732162457,9258,775,8.371138474832577,5.388909133070527,4927,4331,63.0,,9.0,,173,602,681,192089,7101
2021-02-15,S92000003,Scotland,963,193052,3531.869740212221,101.22575923893156,34,7135,130.534211489206,3757,1241839,22719.33772411269,24548,1102,4.489164086687307,5.299851367663845,16652,7896,91.0,,13.0,,273,829,963,193052,7135
2021-02-16,S92000003,Scotland,912,193964,3548.554701792902,104.0431759970728,26,7161,131.0098792535675,3677,1245516,22786.608122941827,25697,1055,4.105537611394326,5.276159663396792,18127,7570,98.0,,8.0,,231,824,912,193964,7161
2021-02-17,S92000003,Scotland,825,194789,3563.6480058543725,103.67727771679472,28,7189,131.52213684595682,3441,1248957,22849.560922063658,20833,978,4.694475111601785,5.152673247207959,13726,7107,74.0,,8.0,,216,762,825,194789,7189
2021-02-18,S92000003,Scotland,879,195668,3579.729235272594,104.3541895353092,35,7224,132.16245883644345,4132,1253089,22925.155506769122,23216,1012,4.359062715368712,5.032455135547918,12021,11195,77.0,,9.0,,217,795,879,195668,7224
2021-02-19,S92000003,Scotland,890,196558,3596.0117087449685,104.13465056714236,44,7268,132.96743505305523,4205,1257294,23002.085620197584,19494,1027,5.268287678259976,4.961265988601887,9536,9958,91.0,,12.0,,188,839,890,196558,7268
2021-02-20,S92000003,Scotland,660,197218,3608.0863519941454,106.29345042078302,27,7295,133.46139773143065,2986,1260280,23056.714233443105,11480,766,6.672473867595817,4.991600136776534,5085,6395,85.0,,3.0,,136,630,660,197218,7295
2021-02-21,S92000003,Scotland,609,197827,3619.227954628613,104.97621661178192,20,7315,133.82729601170877,2501,1262781,23102.46981339188,9866,705,7.145753091425099,4.917341305666968,4677,5189,70.0,,10.0,,142,563,609,197827,7315
2021-02-22,S92000003,Scotland,787,198614,3633.6260519575562,101.7563117453348,22,7337,134.22978412001464,4422,1267203,23183.36992316136,24945,946,3.792343154940871,4.787834517564248,16795,8150,72.0,,9.0,,204,742,787,198614,7337
2021-02-23,S92000003,Scotland,693,199307,3646.3044273691917,97.7497255762898,16,7353,134.5225027442371,3799,1271002,23252.87230150018,25696,809,3.1483499377335,4.6063602154504535,18380,7316,66.0,,6.0,,172,637,693,199307,7353
2021-02-24,S92000003,Scotland,699,200006,3659.0925722649104,95.44456641053787,18,7371,134.85181119648738,3491,1274493,23316.73984632272,21100,796,3.772511848341232,4.46327974844805,14005,7095,57.0,,5.0,,142,654,699,200006,7371
2021-02-25,S92000003,Scotland,628,200634,3670.581778265641,90.85254299304792,20,7391,135.21770947676546,3781,1278274,23385.91291620929,22163,719,3.2441456481523265,4.2807100872766135,11056,11107,49.0,,3.0,,122,597,628,200634,7391
2021-02-26,S92000003,Scotland,514,201148,3679.985364068789,83.97365532381998,16,7407,135.51042810098792,3520,1281794,23450.31101353824,17832,604,3.38716913414087,4.016320764641349,8935,8897,62.0,,6.0,,112,492,514,201148,7407
2021-02-27,S92000003,Scotland,414,201562,3687.5594584705455,79.47310647639956,19,7426,135.8580314672521,2568,1284362,23497.29235272594,10199,503,4.931856064320032,3.8558129300991646,4528,5671,50.0,,4.0,,94,409,414,201562,7426
2021-02-28,S92000003,Scotland,426,201988,3695.3530918404686,76.12513721185509,9,7435,136.02268569337724,2238,1286600,23538.236370289058,9387,489,5.209332054969639,3.705395897107872,4733,4654,53.0,,3.0,,68,421,426,201988,7435
2021-03-01,S92000003,Scotland,547,202535,3705.3604098060737,71.73435784851813,20,7455,136.38858397365533,4056,1290656,23612.440541529457,23843,663,2.780690349368788,3.5194286591921364,16526,7317,66.0,,7.0,,156,507,547,202535,7455
2021-03-02,S92000003,Scotland,518,203053,3714.837175265277,68.53274789608489,12,7467,136.60812294182216,3648,1294304,23679.180387852182,25455,610,2.396385778825378,3.372852537717632,18970,6485,63.0,,4.0,,114,496,518,203053,7467
2021-03-03,S92000003,Scotland,495,203548,3723.893157702159,64.80058543724844,11,7478,136.80936699597513,3287,1297591,23739.31577021588,20016,596,2.97761790567546,3.2460529888669067,13868,6148,40.0,,9.0,,116,480,495,203548,7478
2021-03-04,S92000003,Scotland,558,204106,3734.1017197219176,63.519941456275156,14,7492,137.06549579216977,3455,1301046,23802.524698133922,22368,657,2.9372317596566524,3.192873741285825,11256,11112,45.0,,0.0,,106,551,558,204106,7492
2021-03-05,S92000003,Scotland,465,204571,3742.6088547383833,62.62349066959385,8,7500,137.21185510428106,3637,1304683,23869.06330040249,18562,547,2.946880724059908,3.131017484402681,8799,9763,38.0,,3.0,,101,446,465,204571,7500
2021-03-06,S92000003,Scotland,480,205051,3751.3904134650566,63.83095499451153,10,7510,137.39480424442004,2622,1307305,23917.032564946945,11024,558,5.061683599419449,3.1533427729516665,4639,6385,36.0,,5.0,,76,482,480,205051,7510
2021-03-07,S92000003,Scotland,433,205484,3759.312111233077,63.95901939260885,10,7520,137.5777533845591,2514,1309819,23963.0259787779,10460,497,4.7514340344168255,3.13373011053079,4999,5461,23.0,,4.0,,74,423,433,205484,7520
2021-03-08,S92000003,Scotland,588,206072,3770.069520673253,64.70911086717892,15,7535,137.85217709476765,4535,1314354,24045.99341383096,25490,672,2.6363279717536288,3.1017806935332715,17067,8423,34.0,,2.0,,123,549,588,206072,7535
2021-03-09,S92000003,Scotland,653,206725,3782.0160995243323,67.17892425905599,10,7545,138.0351262349067,4140,1318494,24121.73435784852,26183,741,2.8300805866401864,3.1826282782637225,18479,7704,45.0,,4.0,,103,638,653,206725,7545
2021-03-10,S92000003,Scotland,622,207347,3793.395536040981,69.5023783388218,5,7550,138.12660080497622,3863,1322357,24192.407610684237,21627,698,3.227447172515837,3.22000677896164,13936,7691,34.0,,2.0,,97,601,622,207347,7550
2021-03-11,S92000003,Scotland,662,208009,3805.506769118185,71.40504939626784,8,7558,138.27296011708745,3733,1326090,24260.70252469813,24113,740,3.0688840044789125,3.23951141795008,11811,12302,34.0,,3.0,,115,625,662,208009,7558
2021-03-12,S92000003,Scotland,584,208593,3816.190998902305,73.58214416392244,6,7564,138.3827296011709,3998,1330088,24333.845590925717,21088,654,3.1012898330804246,3.257491874129371,9271,11817,40.0,,2.0,,80,574,584,208593,7564
2021-03-13,S92000003,Scotland,464,209057,3824.679839004757,73.28942553969995,4,7568,138.4559092572265,2678,1332766,24382.83937065496,11672,538,4.609321453050034,3.2282607922749285,4774,6898,28.0,,4.0,,75,463,464,209057,7568
2021-03-14,S92000003,Scotland,443,209500,3832.784485912917,73.472374679839,7,7575,138.5839736553238,2489,1335255,24428.375411635567,10259,504,4.912759528219126,3.2378660134442288,4662,5597,26.0,,4.0,,64,440,443,209500,7575
2021-03-15,S92000003,Scotland,688,210188,3845.371386754481,75.30186608122942,1,7576,138.60226856933772,4579,1339834,24512.147822905234,26180,756,2.8877005347593583,3.2815578010515725,17338,8842,40.0,,4.0,,106,650,688,210188,7576
2021-03-16,S92000003,Scotland,572,210760,3855.836077570436,73.81997804610319,11,7587,138.8035126234907,4209,1344043,24589.15111598976,27225,637,2.3397612488521577,3.184350468473032,19666,7559,25.0,,2.0,,88,549,572,210760,7587
2021-03-17,S92000003,Scotland,597,211357,3866.758141236736,73.36260519575558,8,7595,138.94987193560192,3712,1347755,24657.06183680937,21705,683,3.146740382400369,3.1720588855612277,14299,7406,36.0,,5.0,,93,590,597,211357,7595
2021-03-18,S92000003,Scotland,552,211909,3876.856933772412,71.35016465422612,3,7598,139.0047566776436,3759,1351514,24725.832418587637,24030,618,2.571785268414482,3.0880915031760217,11759,12271,32.0,,0.0,,76,542,552,211909,7598
2021-03-19,S92000003,Scotland,542,212451,3886.772777167947,70.58177826564216,6,7604,139.11452616172704,4238,1355752,24803.36626417856,21978,603,2.7436527436527443,3.0332263769757213,9713,12265,23.0,,2.0,,71,532,542,212451,7604
2021-03-20,S92000003,Scotland,458,212909,3895.151847786316,70.47200878155873,5,7609,139.20600073179656,2815,1358567,24854.8664471277,12041,512,4.25213852670044,3.0072933662441246,4754,7287,19.0,,3.0,,44,468,458,212909,7609
2021-03-21,S92000003,Scotland,463,213372,3903.622392974753,70.83790706183682,4,7613,139.27918038785216,2553,1361120,24901.573362605195,10987,500,4.55083280240284,2.989330262372872,4966,6021,29.0,,2.0,,65,435,463,213372,7613
2021-03-22,S92000003,Scotland,680,214052,3916.062934504208,70.69154774972556,3,7616,139.3340651298939,5337,1366457,24999.213318697402,28230,753,2.6673751328374067,2.9453610221893896,17205,11025,32.0,,1.0,,85,668,680,214052,7616
2021-03-23,S92000003,Scotland,603,214655,3927.094767654593,71.25869008415658,3,7619,139.3889498719356,5223,1371680,25094.767654592026,29221,671,2.2962937613360253,2.92863312459512,19195,10026,28.0,,4.0,,61,610,603,214655,7619
2021-03-24,S92000003,Scotland,541,215196,3936.992316136114,70.23417489937798,4,7623,139.46212952799124,4377,1376057,25174.844493230878,23533,599,2.545361832320571,2.8369550726569783,14363,9170,27.0,,3.0,,65,534,541,215196,7623
2021-03-25,S92000003,Scotland,573,215769,3947.475301866081,70.61836809366994,7,7630,139.59019392608857,4200,1380257,25251.68313208928,25768,645,2.50310462589258,2.8222564873021523,11914,13854,29.0,,4.0,,61,584,573,215769,7630
2021-03-26,S92000003,Scotland,474,216243,3956.1470911086717,69.37431394072448,5,7635,139.6816684961581,4029,1384286,25325.3933406513,22276,525,2.3567965523433294,2.765428526332404,9884,12392,24.0,,3.0,,58,467,474,216243,7635
2021-03-27,S92000003,Scotland,386,216629,3963.208927918039,68.05708013172338,5,7640,139.7731430662276,2845,1387131,25377.44237102085,12223,424,3.468870162807821,2.704318238547537,4921,7302,20.0,,2.0,,31,393,386,216629,7640
2021-03-28,S92000003,Scotland,357,216986,3969.740212221003,66.11781924624954,5,7645,139.86461763629708,2963,1390094,25431.650201244054,12554,406,3.2340289947427117,2.615649686291083,5819,6735,24.0,,4.0,,37,369,357,216986,7645
2021-03-29,S92000003,Scotland,514,217500,3979.143798024149,63.080863519941474,5,7650,139.95609220636663,5486,1395580,25532.016099524328,29314,569,1.941052057037593,2.4785491545558442,18608,10706,22.0,,2.0,,58,511,514,217500,7650
2021-03-30,S92000003,Scotland,394,217894,3986.351994145628,59.25722649103549,2,7652,139.99268203439445,4617,1400197,25616.483717526527,26991,449,1.6635174687858916,2.3693329577686217,18305,8686,20.0,,2.0,,56,393,394,217894,7652
2021-03-31,S92000003,Scotland,394,218288,3993.5601902671056,56.567874130991584,1,7653,140.01097694840834,3877,1404074,25687.413099158442,22337,462,2.0683171419617667,2.297590830763949,14545,7792,21.0,,2.0,,58,404,394,218288,7653
2021-04-01,S92000003,Scotland,413,218701,4001.115989754849,53.64068788876693,1,7654,140.02927186242223,3445,1407519,25750.439077936335,23868,463,1.939835763365175,2.2050908312884867,11925,11943,22.0,,3.0,,52,411,413,218701,7654
2021-04-02,S92000003,Scotland,353,219054,4007.574094401757,51.42700329308454,2,7656,140.06586169045005,2843,1410362,25802.451518477865,16670,397,2.3815236952609475,2.2020464444243766,7173,9497,26.0,,1.0,,41,356,353,219054,7656
2021-04-03,S92000003,Scotland,280,219334,4012.6966703256494,49.48774240761068,2,7658,140.10245151847786,2446,1412808,25847.200878155872,11323,319,2.817274573876181,2.1425026388083066,5195,6128,17.0,,1.0,,36,283,280,219334,7658
2021-04-04,S92000003,Scotland,254,219588,4017.3435784851813,47.60336626417856,1,7659,140.12074643249179,2243,1415051,25888.236370289058,11354,294,2.5893958076448818,2.0816737982616296,6596,4758,15.0,,0.0,,33,261,254,219588,7659
2021-04-05,S92000003,Scotland,293,219881,4022.703988291255,43.56019026710575,4,7663,140.1939260885474,3037,1418088,25943.79802414928,20356,335,1.645706425623895,2.045914566701029,14487,5869,31.0,,2.0,,39,296,293,219881,7663
2021-04-06,S92000003,Scotland,356,220237,4029.216977680205,42.864983534577384,2,7665,140.2305159165752,4018,1422106,26017.30698865715,25299,392,1.5494683584331397,2.028855167788304,17677,7622,19.0,,2.0,,37,355,356,220237,7665
2021-04-07,S92000003,Scotland,282,220519,4034.376143432126,40.81595316502013,2,7667,140.26710574460301,3264,1425370,26077.02158799854,22214,325,1.4630413252903576,1.9262457660736625,15663,6551,22.0,,2.0,,35,290,282,220519,7667
2021-04-08,S92000003,Scotland,282,220801,4039.535309184047,38.41931942919868,2,7669,140.3036955726308,2986,1428356,26131.650201244054,23011,337,1.4645169701447134,1.8421679068088799,12076,10935,22.0,,0.0,,40,297,282,220801,7669
2021-04-09,S92000003,Scotland,266,221067,4044.4017563117454,36.82766190998903,2,7671,140.34028540065862,3066,1431422,26187.742407610687,19469,302,1.5511839334326365,1.7319922421180818,9568,9901,20.0,,0.0,,47,255,266,221067,7671
2021-04-10,S92000003,Scotland,227,221294,4048.5547017929016,35.858031467252104,3,7674,140.39517014270032,2279,1433701,26229.436516648373,10273,265,2.579577533339823,1.7048554282596835,4877,5396,15.0,,1.0,,42,223,227,221294,7674
2021-04-11,S92000003,Scotland,212,221506,4052.433223563849,35.08964507866813,2,7676,140.43175997072814,2183,1435884,26269.374313940723,10044,244,2.4293110314615687,1.6836820596023447,5433,4611,13.0,,1.0,,27,217,212,221506,7676
2021-04-12,S92000003,Scotland,260,221766,4057.189901207464,34.48591291620929,0,7676,140.43175997072814,3641,1439525,26335.986095865348,23934,307,1.2826940753739449,1.617949405560025,17724,6210,14.0,,1.0,,35,272,260,221766,7676
2021-04-13,S92000003,Scotland,261,222027,4061.9648737650928,32.747896084888396,0,7676,140.43175997072814,3332,1442857,26396.944749359678,23988,298,1.2422878105719526,1.5631934884490681,18737,5251,11.0,,2.0,,46,252,261,222027,7676
2021-04-14,S92000003,Scotland,212,222239,4065.843395536041,31.46725210391511,3,7679,140.48664471276985,2819,1445676,26448.518111964877,19990,244,1.2206103051525763,1.5278213435953147,14811,5179,15.0,,2.0,,26,218,212,222239,7679
2021-04-15,S92000003,Scotland,198,222437,4069.465788510794,29.930479326747164,2,7681,140.52323454079766,2719,1448395,26498.261983168682,20883,241,1.15404874778528,1.4784454935021505,11738,9145,15.0,,0.0,,39,202,198,222437,7681
2021-04-16,S92000003,Scotland,382,222819,4076.454445664105,32.052689352360055,1,7682,140.54152945481155,2553,1450948,26544.968898646177,18006,633,3.5154948350549815,1.7558488963010743,9111,8895,14.0,,1.0,,30,603,382,222819,7682
2021-04-17,S92000003,Scotland,202,223021,4080.150018294914,31.595316502012444,1,7683,140.55982436882545,1875,1452823,26579.27186242225,9551,228,2.3871845880012565,1.7366055887844554,4604,4947,10.0,,2.0,,27,201,202,223021,7683
2021-04-18,S92000003,Scotland,178,223199,4083.406512989389,30.973289425539694,0,7683,140.55982436882545,2006,1454829,26615.971459934146,10190,215,2.1099116781158,1.7116846580581941,5960,4230,12.0,,0.0,,24,191,178,223199,7683
2021-04-19,S92000003,Scotland,264,223463,4088.2363702890602,31.046469081595315,1,7684,140.57811928283937,3533,1458362,26680.607391145262,24469,301,1.2301279169561483,1.6997568403408956,18435,6034,14.0,,2.0,,39,262,264,223463,7684
2021-04-20,S92000003,Scotland,242,223705,4092.6637394804247,30.69886571533113,1,7685,140.5964141968533,3344,1461706,26741.785583607758,24253,261,1.0761555271512802,1.6671640150146847,19079,5174,13.0,,0.0,,35,226,242,223705,7685
2021-04-21,S92000003,Scotland,237,223942,4096.99963410172,31.15623856567874,3,7688,140.651298938895,2837,1464543,26793.688254665205,19331,265,1.3708551032021106,1.6924133467000306,14137,5194,13.0,,1.0,,38,227,237,223942,7688
2021-04-22,S92000003,Scotland,231,224173,4101.2257592389315,31.75997072813757,0,7688,140.651298938895,2760,1467303,26844.182217343576,21069,271,1.2862499406711283,1.7135785731739035,11559,9510,11.0,,1.0,,38,233,231,224173,7688
2021-04-23,S92000003,Scotland,188,224361,4104.665203073546,28.210757409440173,2,7690,140.68788876692278,2834,1470137,26896.030003658983,18238,214,1.1733742734949009,1.3807916538815588,9523,8715,12.0,,1.0,,27,187,188,224361,7690
2021-04-24,S92000003,Scotland,150,224511,4107.409440175631,27.259421880717163,0,7690,140.68788876692278,2050,1472187,26933.53457738749,9773,173,1.7701831576793206,1.3351868868939627,4894,4879,9.0,,2.0,,23,150,150,224511,7690
2021-04-25,S92000003,Scotland,109,224620,4109.403585803147,25.997072813757768,2,7692,140.7244785949506,1967,1474154,26969.520673252842,10108,127,1.2564305500593589,1.266887245463333,6252,3856,9.0,,0.0,,14,113,109,224620,7692
2021-04-26,S92000003,Scotland,195,224815,4112.971094035858,24.73472374679839,2,7694,140.7610684229784,3754,1477908,27038.19978046103,25421,217,0.85362495574525,1.1919527587309755,19270,6151,12.0,,1.0,,26,191,195,224815,7694
2021-04-27,S92000003,Scotland,195,225010,4116.538602268569,23.87486278814489,1,7695,140.77936333699233,3647,1481555,27104.92133186974,24308,226,0.9297350666447259,1.1641507080032438,18654,5654,12.0,,2.0,,34,192,195,225010,7695
2021-04-28,S92000003,Scotland,193,225203,4120.0695206732535,23.069886571533107,1,7696,140.79765825100625,2818,1484373,27156.476399560917,19692,217,1.101970343286614,1.1235605595253833,14499,5193,8.0,,0.0,,43,174,193,225203,7696
2021-04-29,S92000003,Scotland,174,225377,4123.252835711673,22.02707647274058,0,7696,140.79765825100625,2623,1486996,27204.46395901939,20734,199,0.9597762129835054,1.070364999922042,11605,9129,9.0,,0.0,,24,175,174,225377,7696
2021-04-30,S92000003,Scotland,172,225549,4126.399560922064,21.734357848518115,0,7696,140.79765825100625,2695,1489691,27253.768752286865,17120,197,1.1507009345794392,1.0664066186416683,8364,8756,9.0,,3.0,,24,173,172,225549,7696
2021-05-01,S92000003,Scotland,126,225675,4128.704720087815,21.295279912184405,0,7696,140.79765825100625,2095,1491786,27292.096597145992,9463,145,1.5322836309838317,1.0469388076880626,4648,4815,8.0,,1.0,,10,135,126,225675,7696
2021-05-02,S92000003,Scotland,121,225796,4130.918404683498,21.51481888035126,1,7697,140.81595316502012,1950,1493736,27327.771679473106,9908,135,1.3625353249899073,1.0549089588301248,6078,3830,7.0,,1.0,,14,121,121,225796,7697
2021-05-03,S92000003,Scotland,162,225958,4133.8821807537515,20.911086717892424,0,7697,140.81595316502012,3153,1496889,27385.455543358945,21235,174,0.8194019307746645,1.0558549730524254,16342,4893,6.0,,2.0,,15,159,162,225958,7697
2021-05-04,S92000003,Scotland,196,226154,4137.467983900476,20.929381631906327,0,7697,140.81595316502012,3939,1500828,27457.51920965972,26391,213,0.8070933272706604,1.0277574813518222,19730,6661,11.0,,2.0,,19,194,196,226154,7697
2021-05-05,S92000003,Scotland,222,226376,4141.529454811562,21.45993413830955,0,7697,140.81595316502012,3140,1503968,27514.965239663376,20649,245,1.18649813550293,1.0422310756972113,14668,5981,9.0,,0.0,,33,212,222,226376,7697
2021-05-06,S92000003,Scotland,218,226594,4145.517746066593,22.264910354921327,0,7697,140.81595316502012,2812,1506780,27566.410537870473,21320,242,1.1350844277673546,1.0714908871722475,11806,9514,18.0,,2.0,,25,217,218,226594,7697
2021-05-07,S92000003,Scotland,203,226797,4149.231613611416,22.83205268935237,0,7697,140.81595316502012,3098,1509878,27623.088181485542,18877,226,1.1972241351909731,1.0794490116783868,9758,9119,12.0,,1.0,,19,207,203,226797,7697
2021-05-08,S92000003,Scotland,185,226982,4152.616172703989,23.911452616172706,0,7697,140.81595316502012,2402,1512280,27667.03256494695,10196,200,1.9615535504119264,1.1160714285714286,4919,5277,11.0,,1.0,,19,181,185,226982,7697
2021-05-09,S92000003,Scotland,210,227192,4156.458104646908,25.539699963410172,0,7697,140.81595316502012,2374,1514654,27710.464690815963,11022,226,2.050444565414625,1.176652016346673,6194,4828,12.0,,0.0,,18,208,210,227192,7697
2021-05-10,S92000003,Scotland,329,227521,4162.477131357482,28.594950603732162,0,7697,140.81595316502012,4469,1519123,27792.224661544093,26438,361,1.3654588092896591,1.269895398575167,18620,7818,7.0,,3.0,,27,334,329,227521,7697
2021-05-11,S92000003,Scotland,283,227804,4167.6545920234175,30.186608122941823,0,7697,140.81595316502012,4118,1523241,27867.56311745335,26398,316,1.197060383362376,1.346182357301705,19663,6735,18.0,,1.0,,27,289,283,227804,7697
2021-05-12,S92000003,Scotland,298,228102,4173.106476399561,31.577021587998534,2,7699,140.8525429930479,3562,1526803,27932.729601170875,21132,322,1.5237554419837214,1.3982553200918877,14401,6731,11.0,,0.0,,31,291,298,228102,7699
2021-05-13,S92000003,Scotland,314,228416,4178.851079399927,33.333333333333336,0,7699,140.8525429930479,3153,1529956,27990.413465056714,21996,332,1.5093653391525732,1.4574559566070602,11778,10218,14.0,,0.0,,48,284,314,228416,7699
2021-05-14,S92000003,Scotland,291,228707,4184.174899377973,34.9432857665569,0,7699,140.8525429930479,3649,1533605,28057.171606293454,19968,314,1.5725160256410255,1.5100255195041925,9647,10321,9.0,,0.0,,14,300,291,228707,7699
2021-05-15,S92000003,Scotland,228,228935,4188.346139773143,35.729967069154775,0,7699,140.8525429930479,2918,1536523,28110.556165386024,11338,247,2.178514729229141,1.531541954704538,4944,6394,6.0,,0.0,,18,229,228,228935,7699
2021-05-16,S92000003,Scotland,231,229166,4192.5722649103545,36.11416026344676,0,7699,140.8525429930479,2632,1539155,28158.708379070617,12141,246,2.026192241166296,1.5335949100142745,6584,5557,11.0,,1.0,,21,225,231,229166,7699
2021-05-17,S92000003,Scotland,361,229527,4199.176728869375,36.699597511891696,1,7700,140.87083790706185,5452,1544607,28258.452250274422,29171,401,1.3746529087107058,1.5322489869428186,19121,10050,11.0,,1.0,,24,377,361,229527,7700
2021-05-18,S92000003,Scotland,417,229944,4206.805708013173,39.15111598975486,0,7700,140.87083790706185,4715,1549322,28344.712769849986,28079,448,1.5954984151857257,1.6061185468451242,19639,8440,20.0,,0.0,,47,401,417,229944,7700
2021-05-19,S92000003,Scotland,409,230353,4214.288327844859,41.18185144529821,0,7700,140.87083790706185,4428,1553750,28425.72264910355,23257,447,1.9220019778991275,1.6683795820486471,14727,8530,19.0,,1.0,,31,416,409,230353,7700
2021-05-20,S92000003,Scotland,381,230734,4221.258690084156,42.40761068422978,0,7700,140.87083790706185,4277,1558027,28503.969996341017,25122,417,1.659899689515166,1.6904129437333983,11922,13200,21.0,,1.0,,42,375,381,230734,7700
2021-05-21,S92000003,Scotland,360,231094,4227.8448591291635,43.669959751189175,0,7700,140.87083790706185,4487,1562514,28586.059275521402,22097,400,1.810200479703128,1.7234879798948448,9736,12361,25.0,,3.0,,22,378,360,231094,7700
2021-05-22,S92000003,Scotland,291,231385,4233.168679107208,44.822539334065134,1,7701,140.88913282107575,3180,1565694,28644.23710208562,12203,319,2.6141112841104643,1.7610311040967976,4997,7206,21.0,,1.0,,29,290,291,231385,7701
2021-05-23,S92000003,Scotland,324,231709,4239.096231247713,46.52396633735821,1,7702,140.90742773508958,2864,1568558,28696.63373582144,12899,359,2.783161485386464,1.8262360300468496,6590,6309,16.0,,0.0,,25,334,324,231709,7702
2021-05-24,S92000003,Scotland,496,232205,4248.1705085986105,48.99377972923528,0,7702,140.90742773508958,5460,1574018,28796.523966337358,29159,531,1.8210501045989231,1.911449062925348,18519,10640,21.0,,1.0,,34,497,496,232205,7702
2021-05-25,S92000003,Scotland,504,232709,4257.3911452616185,50.585437248444926,0,7702,140.90742773508958,5205,1579223,28891.748993779733,29658,564,1.9016791422213235,1.9670326111596883,19953,9705,21.0,,1.0,,46,518,504,232709,7702
2021-05-26,S92000003,Scotland,627,233336,4268.862056348336,54.57372850347602,1,7703,140.92572264910353,4536,1583759,28974.734723746802,24416,665,2.7236238532110093,2.0925209252092523,14812,9604,14.0,,1.0,,29,636,627,233336,7703
2021-05-27,S92000003,Scotland,552,233888,4278.96084888401,57.70215879985364,1,7704,140.94401756311746,4254,1588013,29052.561287961948,24876,588,2.363724071394115,2.205939166044248,11738,13138,18.0,,1.0,,33,555,552,233888,7704
2021-05-28,S92000003,Scotland,549,234437,4289.004756677644,61.159897548481524,1,7705,140.96231247713138,4148,1592161,29128.44859129162,21313,593,2.7823394172570737,2.3420310113639307,9309,12004,28.0,,1.0,,30,563,549,234437,7705
2021-05-29,S92000003,Scotland,435,234872,4296.963044273692,63.794365166483715,2,7707,140.99890230515916,3119,1595280,29185.510428100988,12378,464,3.7485862013249314,2.433112043387481,4933,7445,26.0,,1.0,,27,437,435,234872,7707
2021-05-30,S92000003,Scotland,486,235358,4305.8543724844485,66.75814123673621,1,7708,141.01719721917308,2982,1598262,29240.065861690447,12839,526,4.096892281330321,2.542049547656154,6362,6477,21.0,,1.0,,21,505,486,235358,7708
2021-05-31,S92000003,Scotland,601,235959,4316.849615806807,68.67910720819613,0,7708,141.01719721917308,4576,1602838,29323.783388218082,26443,676,2.556442158605302,2.6829380673104137,17715,8728,23.0,,0.0,,35,641,601,235959,7708
2021-06-01,S92000003,Scotland,773,236732,4330.991584339554,73.60043907793633,0,7708,141.01719721917308,6008,1608846,29433.699231613613,31093,867,2.7884089666484417,2.8554102166173267,19288,11805,31.0,,4.0,,46,821,773,236732,7708
2021-06-02,S92000003,Scotland,959,237691,4348.536406878888,79.67435053055252,1,7709,141.03549213318698,5577,1614423,29535.72996706916,26574,1017,3.827048995258523,3.042130713238509,14594,11980,22.0,,2.0,,44,973,959,237691,7709
2021-06-03,S92000003,Scotland,949,238640,4365.898280278083,86.93743139407246,2,7711,141.07208196121476,5402,1619825,29634.559092572264,28337,1024,3.6136499982355232,3.2501556828975247,12195,16142,33.0,,0.0,,65,959,949,238640,7711
2021-06-04,S92000003,Scotland,822,239462,4380.936699597512,91.93194291986828,1,7712,141.09037687522869,5839,1625664,29741.38309549945,26186,889,3.394943863132972,3.3341470857491613,10340,15846,21.0,,1.0,,42,847,822,239462,7712
2021-06-05,S92000003,Scotland,606,240068,4392.023417489938,95.06037321624588,0,7712,141.09037687522869,3911,1629575,29812.934504207828,14138,652,4.6116848210496535,3.4122335607753165,5030,9108,20.0,,2.0,,23,629,606,240068,7712
2021-06-06,S92000003,Scotland,677,240745,4404.409074277352,98.55470179290155,1,7713,141.10867178924258,3759,1633334,29881.705085986094,14982,726,4.845814977973569,3.4878660888329867,6843,8139,29.0,,2.0,,35,691,677,240745,7713
2021-06-07,S92000003,Scotland,953,241698,4421.844127332602,104.99451152579584,1,7714,141.1269667032565,6654,1639988,30003.439443834613,31989,1021,3.191722154490606,3.5753235737078684,18239,13750,29.0,,4.0,,44,977,953,241698,7714
2021-06-08,S92000003,Scotland,1026,242724,4440.614709110867,109.62312477131357,0,7714,141.1269667032565,6363,1646351,30119.849981705087,32778,1104,3.3681127585575688,3.67633612215974,20062,12716,23.0,,1.0,,48,1056,1026,242724,7714
2021-06-09,S92000003,Scotland,1056,243780,4459.93413830955,111.39773143066229,2,7716,141.1635565312843,5748,1652099,30225.009147457004,27482,1118,4.0681173131504265,3.7147795237986947,14720,12762,31.0,,0.0,,49,1069,1056,243780,7716
2021-06-10,S92000003,Scotland,1040,244820,4478.96084888401,113.06256860592757,2,7718,141.2001463593121,5267,1657366,30321.36845956824,27492,1136,4.132111159610068,3.796694602021172,11830,15662,32.0,,2.0,,46,1090,1040,244820,7718
2021-06-11,S92000003,Scotland,865,245685,4494.7859495060375,113.84924990852542,0,7718,141.2001463593121,5318,1662684,30418.660812294183,24668,959,3.887627695800227,3.870246471771289,10004,14664,25.0,,3.0,,43,916,865,245685,7718
2021-06-12,S92000003,Scotland,706,246391,4507.702158799853,115.67874130991585,0,7718,141.2001463593121,3822,1666506,30488.583973655317,14337,765,5.335844318895166,3.9308574323079757,5058,9279,33.0,,1.0,,36,729,706,246391,7718
2021-06-13,S92000003,Scotland,855,247246,4523.344310281742,118.93523600439077,3,7721,141.25503110135384,3678,1670184,30555.87266739846,14971,919,6.138534500033398,4.042206577364333,6343,8628,24.0,,2.0,,36,883,855,247246,7721
2021-06-14,S92000003,Scotland,1129,248375,4543.999268203439,122.1551408708379,1,7722,141.27332601536773,7374,1677558,30690.779363336987,34762,1219,3.5067027213624065,4.090883336166355,19246,15516,41.0,,1.0,,63,1156,1129,248375,7722
2021-06-15,S92000003,Scotland,1279,249654,4567.398463227223,126.78375411635568,6,7728,141.38309549945112,6905,1684463,30817.105744603003,34481,1366,3.9616020417041273,4.198818135392523,19543,14938,33.0,,2.0,,68,1298,1279,249654,7728
2021-06-16,S92000003,Scotland,1265,250919,4590.541529454811,130.6073911452616,1,7729,141.4013904134651,6682,1691145,30939.352360043908,30130,1352,4.487222037836044,4.266731548708534,15025,15105,40.0,,0.0,,73,1279,1265,250919,7729
2021-06-17,S92000003,Scotland,1164,252083,4611.836809366996,132.87596048298573,1,7730,141.41968532747896,6225,1697370,31053.238199780462,30097,1249,4.1499152739475695,4.267740915582787,12347,17750,24.0,,1.0,,64,1185,1164,252083,7730
2021-06-18,S92000003,Scotland,1231,253314,4634.357848518112,139.57189901207465,3,7733,141.4745700695207,5636,1703006,31156.348335162827,25676,1323,5.152671755725192,4.441757836642198,9942,15734,46.0,,4.0,,76,1247,1231,253314,7733
2021-06-19,S92000003,Scotland,997,254311,4652.597877789975,144.89571899012074,2,7735,141.51115989754845,4376,1707382,31236.406878887672,15914,1082,6.799044866155588,4.574506399471057,5061,10853,27.0,,1.0,,39,1043,997,254311,7735
2021-06-20,S92000003,Scotland,1548,255859,4680.918404683498,157.5740944017563,3,7738,141.5660446395902,4742,1712124,31323.161361141603,18716,1647,8.799957255823895,4.867844195261783,6628,12088,30.0,,1.0,,50,1597,1548,255859,7738
2021-06-21,S92000003,Scotland,3019,258878,4736.150750091474,192.1514818880352,2,7740,141.602634467618,8932,1721056,31486.571533113794,41143,3163,7.687820528400942,5.700535795306821,19107,22036,35.0,,5.0,,93,3070,3019,258878,7740
2021-06-22,S92000003,Scotland,3243,262121,4795.481156238567,228.08269301134285,4,7744,141.67581412367363,8941,1729997,31650.146359312108,41982,3405,8.110618836644276,6.491765607047107,20106,21876,46.0,,0.0,,109,3296,3243,262121,7744
2021-06-23,S92000003,Scotland,2891,265012,4848.371752652764,257.8302231979509,1,7745,141.69410903768753,8738,1738735,31810.00731796561,36501,3074,8.421687077066384,7.114731775135814,14843,21658,55.0,,1.0,,119,2955,2891,265012,7745
2021-06-24,S92000003,Scotland,2947,267959,4902.286864251739,290.45005488474214,2,7747,141.7306988657153,8428,1747163,31964.196853274785,37891,3098,8.176084030508564,7.709011445072376,12669,25222,50.0,,1.0,,123,2975,2947,267959,7747
2021-06-25,S92000003,Scotland,2619,270578,4950.201244054153,315.843395536041,1,7748,141.74899377972926,7189,1754352,32095.718990120742,31780,2809,8.838892385147892,8.162481522996332,10511,21269,42.0,,2.0,,90,2719,2619,270578,7748
2021-06-26,S92000003,Scotland,2292,272870,4992.133186974021,339.5353091840468,8,7756,141.8953530918405,5162,1759514,32190.157336260523,20060,2441,12.168494516450648,8.609962599693958,5382,14678,30.0,,0.0,,89,2352,2292,272870,7756
2021-06-27,S92000003,Scotland,2511,275381,5038.071716062934,357.1533113794365,3,7759,141.95023783388217,4950,1764464,32280.717160629345,20614,2628,12.748617444455226,8.965478255954011,6590,14024,36.0,,3.0,,76,2552,2511,275381,7759
2021-06-28,S92000003,Scotland,3922,279303,5109.824368825466,373.673618733992,3,7762,142.00512257592388,9111,1773575,32447.402122210024,43063,4145,9.625432505863502,9.314721140535855,19601,23462,59.0,,2.0,,161,3984,3922,279303,7762
2021-06-29,S92000003,Scotland,3873,283176,5180.680570801317,385.1994145627516,3,7765,142.0600073179656,8212,1781787,32597.639956092207,40799,4098,10.044363832446873,9.662863879882797,19456,21343,69.0,,0.0,,149,3949,3873,283176,7765
2021-06-30,S92000003,Scotland,3907,287083,5252.158799853641,403.7870472008782,1,7766,142.0783022319795,8169,1789956,32747.091108671782,37024,4160,11.235955056179774,10.110668552226992,15079,21945,68.0,,3.0,,159,4001,3907,287083,7766
2021-07-01,S92000003,Scotland,3429,290512,5314.892060007318,412.60519575558,2,7768,142.1148920600073,7557,1797513,32885.34577387486,36771,3672,9.986130374479886,10.409324195714243,13058,23713,62.0,,6.0,,150,3522,3429,290512,7768
2021-07-02,S92000003,Scotland,3078,293590,5371.203805342115,421.002561287962,2,7770,142.15148188803514,6817,1804330,33010.062202707646,31788,3333,10.485088712721783,10.636670592171876,10161,21627,66.0,,3.0,,167,3166,3078,293590,7770
2021-07-03,S92000003,Scotland,2509,296099,5417.105744603001,424.97255762897913,4,7774,142.22466154409074,5265,1809595,33106.38492499085,21238,2714,12.778981071663996,10.700527892709374,5570,15668,55.0,,5.0,,106,2608,2509,296099,7774
2021-07-04,S92000003,Scotland,2407,298506,5461.141602634468,423.06988657153306,6,7780,142.33443102817418,4688,1814283,33192.15148188803,21093,2576,12.212582373299199,10.6559781858346,7565,13528,68.0,,4.0,,129,2447,2407,298506,7780
2021-07-05,S92000003,Scotland,3378,301884,5522.941822173436,413.1174533479692,5,7785,142.4259055982437,8098,1822381,33340.303695572635,40314,3687,9.145706206280693,10.583904954437687,19216,21098,83.0,,9.0,,186,3501,3378,301884,7785
2021-07-06,S92000003,Scotland,3091,304975,5579.491401390414,398.8108305890962,13,7798,142.66373948042445,7534,1829915,33478.137577753376,38691,3378,8.730712568814452,10.36493198013388,19752,18939,101.0,,2.0,,205,3173,3091,304975,7798
2021-07-07,S92000003,Scotland,2896,307871,5632.4734723746815,380.3146725210392,5,7803,142.75521405049398,6306,1836221,33593.50530552506,31993,3221,10.06782733723002,10.176755840784539,14830,17163,89.0,,8.0,,193,3028,2896,307871,7803
2021-07-08,S92000003,Scotland,2729,310600,5682.400292718624,367.50823271130616,12,7815,142.9747530186608,5795,1842016,33699.52433223563,32431,3017,9.302827541549751,10.078695276444737,12800,19631,102.0,,7.0,,186,2831,2729,310600,7815
2021-07-09,S92000003,Scotland,2382,312982,5725.978777899742,354.774972557629,7,7822,143.10281741675809,5598,1847614,33801.93926088547,27584,2678,9.70852668213457,9.970282735863208,10182,17402,83.0,,5.0,,173,2505,2382,312982,7822
2021-07-10,S92000003,Scotland,1812,314794,5759.129162092938,342.0234174899378,8,7830,143.24917672886937,4019,1851633,33875.46652030736,17126,2017,11.777414457549925,9.833103922918099,5153,11973,83.0,,5.0,,116,1901,1812,314794,7830
2021-07-11,S92000003,Scotland,1881,316675,5793.541895353092,332.4002927186242,6,7836,143.35894621295282,3799,1855432,33944.968898646184,18203,2068,11.360764709113884,9.724631921760961,7378,10825,73.0,,5.0,,138,1930,1881,316675,7836
2021-07-12,S92000003,Scotland,2577,319252,5840.687888766923,317.746066593487,7,7843,143.48701061105012,6656,1862088,34066.73984632272,35274,2883,8.173158700459263,9.568707712789738,18335,16939,102.0,,7.0,,197,2686,2577,319252,7843
2021-07-13,S92000003,Scotland,2443,321695,5885.382363702891,305.8909623124772,9,7852,143.65166483717528,6045,1868133,34177.332601536786,34532,2710,7.847793351094638,9.431732295846162,19078,15454,104.0,,7.0,,256,2454,2443,321695,7852
2021-07-14,S92000003,Scotland,2204,323899,5925.704354189536,293.2308818148555,8,7860,143.7980241492865,5224,1873357,34272.90523234541,28490,2487,8.72937872937873,9.223300970873787,14400,14090,79.0,,4.0,,184,2303,2204,323899,7860
2021-07-15,S92000003,Scotland,1963,325862,5961.6172703988295,279.2169776802049,7,7867,143.92608854738384,4818,1878175,34361.050128064395,28048,2221,7.918568168853395,9.01631115361651,12324,15724,78.0,,7.0,,190,2031,1963,325862,7867
2021-07-16,S92000003,Scotland,1749,327611,5993.615075009146,267.6362971094036,5,7872,144.0175631174534,4577,1882752,34444.78594950603,24094,1955,8.114053291275836,8.796503146414594,9551,14543,68.0,,8.0,,135,1820,1749,327611,7872
2021-07-17,S92000003,Scotland,1400,329011,6019.2279546286145,260.0987925356751,7,7879,144.1456275155507,3365,1886117,34506.348335162824,14527,1578,10.862531837268534,8.681647449336129,4785,9742,49.0,,6.0,,101,1477,1400,329011,7879
2021-07-18,S92000003,Scotland,1385,330396,6044.56641053787,251.02451518477864,8,7887,144.2919868276619,3295,1889412,34566.630076838635,16413,1547,9.425455431670017,8.480080274344187,6969,9444,67.0,,6.0,,107,1440,1385,330396,7887
2021-07-19,S92000003,Scotland,1908,332304,6079.4731064764,238.78521770947674,9,7896,144.45664105378705,6025,1895437,34676.85693377241,32922,2147,6.52147500151874,8.180376034765901,18462,14460,77.0,,5.0,,175,1972,1908,332304,7896
2021-07-20,S92000003,Scotland,1598,333902,6108.7083790706165,223.32601536772785,6,7902,144.5664105378705,5428,1900865,34776.161727039886,30841,1799,5.833144191174086,7.833005389682608,18703,12138,66.0,,9.0,,160,1639,1598,333902,7902
2021-07-21,S92000003,Scotland,1573,335475,6137.48627881449,211.78192462495429,8,7910,144.7127698499817,4853,1905718,34864.94694474936,25516,1739,6.8153315566703245,7.534186968049616,13784,11732,74.0,,6.0,,140,1599,1573,335475,7910
2021-07-22,S92000003,Scotland,1378,336853,6162.696670325649,201.0793999268204,9,7919,144.87742407610685,4411,1910129,34945.645810464695,25587,1551,6.061671942783445,7.248969982342553,11447,14140,58.0,,10.0,,130,1421,1378,336853,7919
2021-07-23,S92000003,Scotland,1277,338130,6186.059275521405,192.44420051225757,7,7926,145.00548847420416,4131,1914260,35021.222100256135,22131,1437,6.493154398807103,7.0252535176881805,9387,12744,62.0,,6.0,,115,1322,1277,338130,7926
2021-07-24,S92000003,Scotland,954,339084,6203.512623490669,184.28466886205638,3,7929,145.0603732162459,3233,1917493,35080.36955726308,13585,1064,7.832167832167832,6.757088535584898,4846,8739,43.0,,7.0,,81,983,954,339084,7929
2021-07-25,S92000003,Scotland,942,340026,6220.746432491767,176.18002195389684,5,7934,145.15184778631541,3131,1920624,35137.65093304061,14678,1035,7.051369396375527,6.518213723829117,6958,7720,53.0,,6.0,,98,937,942,340026,7934
2021-07-26,S92000003,Scotland,1372,341398,6245.847054518844,166.3739480424442,7,7941,145.27991218441272,6061,1926685,35248.536406878884,31792,1551,4.878585807750378,6.199963443611772,18390,13402,53.0,,4.0,,128,1423,1372,341398,7941
2021-07-27,S92000003,Scotland,1353,342751,6270.600073179657,161.89169410903767,8,7949,145.42627149652398,5100,1931785,35341.8404683498,29538,1503,5.088360755636806,6.06778974003083,18218,11320,59.0,,5.0,,145,1358,1353,342751,7949
2021-07-28,S92000003,Scotland,1286,344037,6294.127332601537,156.64105378704718,9,7958,145.5909257226491,4271,1936056,35419.978046103184,23773,1418,5.964749926387078,5.934170991532367,13209,10564,67.0,,3.0,,121,1297,1286,344037,7958
2021-07-29,S92000003,Scotland,1171,345208,6315.5506769118165,152.85400658616902,6,7964,145.70069520673255,4104,1940160,35495.06037321625,24705,1299,5.2580449301760765,5.809540455175341,11154,13551,43.0,,3.0,,101,1198,1171,345208,7964
2021-07-30,S92000003,Scotland,1034,346242,6334.467618002196,148.40834248079034,7,7971,145.82875960482988,3899,1944059,35566.39224295645,21570,1141,5.289754288363468,5.644539936482482,9591,11979,51.0,,3.0,,99,1042,1034,346242,7971
2021-07-31,S92000003,Scotland,769,347011,6348.536406878888,145.0237833882181,6,7977,145.9385290889133,3309,1947368,35626.93011342847,13234,874,6.604201299682638,5.537698537259087,4912,8322,34.0,,5.0,,64,810,769,347011,7977
2021-08-01,S92000003,Scotland,873,347884,6364.5078668130245,143.7614343212587,10,7987,146.12147822905234,3275,1950643,35686.845956824014,14685,957,6.516853932584269,5.4884900531711205,6828,7857,38.0,,3.0,,95,862,873,347884,7987
2021-08-02,S92000003,Scotland,1322,349206,6388.693743139408,142.8466886205635,7,7994,146.24954262714962,5350,1955993,35784.7237467984,29532,1454,4.923472843017743,5.505708845686049,17369,12163,49.0,,5.0,,145,1309,1322,349206,7994
2021-08-03,S92000003,Scotland,1366,350572,6413.684595682401,143.08452250274425,3,7997,146.3044273691914,4943,1960936,35875.155506769115,29373,1481,5.042045415858102,5.497475648936713,18172,11201,50.0,,3.0,,112,1369,1366,350572,7997
2021-08-04,S92000003,Scotland,1292,351864,6437.321624588364,143.19429198682766,6,8003,146.4141968532748,4484,1965420,35957.189901207465,24313,1413,5.811705671862789,5.475440245978706,13452,10861,38.0,,4.0,,91,1322,1292,351864,8003
2021-08-05,S92000003,Scotland,1331,353195,6461.672155140872,146.12147822905234,7,8010,146.54226125137208,4582,1970002,36041.017197219175,25970,1459,5.618020793222951,5.532622875400971,11808,14162,69.0,,3.0,,75,1384,1331,353195,8010
2021-08-06,S92000003,Scotland,1256,354451,6484.6505671423365,150.18294914013902,7,8017,146.67032564946942,4392,1974394,36121.36845956824,21926,1385,6.3167016327647545,5.673665214137946,9072,12854,54.0,,1.0,,105,1280,1256,354451,8017
2021-08-07,S92000003,Scotland,941,355392,6501.8660812294165,153.32967435053058,6,8023,146.78009513355292,3439,1977833,36184.284668862056,13939,1021,7.324772221823659,5.740650314890634,4900,9039,41.0,,4.0,,63,958,941,355392,8023
2021-08-08,S92000003,Scotland,1040,356432,6520.892791803878,156.38492499085254,6,8029,146.8898646176363,3274,1981107,36244.18221734358,15540,1131,7.277992277992277,5.818435423710872,6946,8594,40.0,,3.0,,96,1035,1040,356432,8029
2021-08-09,S92000003,Scotland,1488,357920,6548.115623856568,159.42188071716063,6,8035,146.99963410171972,6487,1987594,36362.86132455178,33156,1617,4.876945349258053,5.7892909991048445,17944,15212,37.0,,3.0,,114,1503,1488,357920,8035
2021-08-10,S92000003,Scotland,1518,359438,6575.887303329675,162.20270764727402,5,8040,147.09110867178924,5486,1993080,36463.22722283205,30494,1666,5.463369843247851,5.861931316454777,18167,12327,70.0,,5.0,,141,1525,1518,359438,8040
2021-08-11,S92000003,Scotland,1567,361005,6604.55543358946,167.23380900109768,3,8043,147.14599341383098,5155,1998235,36557.53750457373,25656,1701,6.630028063610853,5.98748507628344,13290,12366,41.0,,2.0,,127,1574,1567,361005,8043
2021-08-12,S92000003,Scotland,1391,362396,6630.003658982801,168.33150384193198,4,8047,147.21917306988658,4783,2003018,36645.042078302235,26307,1537,5.842551412171665,6.022105401812977,11523,14784,39.0,,3.0,,110,1427,1391,362396,8047
2021-08-13,S92000003,Scotland,1523,363919,6657.8668130259775,173.21624588364438,10,8057,147.40212221002562,5144,2008162,36739.151115989764,23819,1670,7.011209538603637,6.123343062322763,9426,14393,40.0,,3.0,,110,1560,1523,363919,8057
2021-08-14,S92000003,Scotland,1471,365390,6684.778631540432,182.9125503110136,6,8063,147.51189169410904,3849,2012011,36809.568240029264,15665,1573,10.04149377593361,6.384898937510622,5160,10505,45.0,,2.0,,73,1500,1471,365390,8063
2021-08-15,S92000003,Scotland,1628,367018,6714.562751555067,193.6699597511892,6,8069,147.62166117819245,4252,2016263,36887.3582144164,18369,1734,9.439817083129183,6.6283882720533125,7156,11213,31.0,,5.0,,93,1641,1628,367018,8069
2021-08-16,S92000003,Scotland,2746,369764,6764.800585437249,216.68496158068055,3,8072,147.6765459202342,7842,2024105,37030.82693011344,37463,2898,7.735632490724182,7.188380687730982,18042,19421,34.0,,5.0,,151,2747,2746,369764,8072
2021-08-17,S92000003,Scotland,3362,373126,6826.308086351994,250.4207830223198,4,8076,147.74972557628982,7791,2031896,37173.36260519576,38854,3561,9.165079528491276,7.883610106751622,18397,20457,60.0,,1.0,,185,3376,3362,373126,8076
2021-08-18,S92000003,Scotland,3704,376830,6894.072447859495,289.51701427003286,7,8083,147.8777899743871,7613,2039509,37312.6417855836,35703,3964,11.102708455872056,8.633397899887859,14299,21404,61.0,,1.0,,207,3757,3704,376830,8083
2021-08-19,S92000003,Scotland,3711,380541,6961.964873765093,331.9612147822905,7,8090,148.00585437248444,8033,2047542,37459.6048298573,37963,3938,10.373258172431052,9.304451586828076,12142,25821,59.0,,2.0,,182,3756,3711,380541,8090
2021-08-20,S92000003,Scotland,3422,383963,7024.570069520672,366.70325649469453,7,8097,148.13391877058174,7734,2055276,37601.09769484084,34134,3665,10.7370949786137,9.779006284637703,10503,23631,66.0,,1.0,,182,3483,3422,383963,8097
2021-08-21,S92000003,Scotland,3030,386993,7080.003658982801,395.225027442371,5,8102,148.22539334065132,6113,2061389,37712.93450420784,23382,3230,13.814044991874091,10.178511342908248,5527,17855,48.0,,5.0,,125,3105,3030,386993,8102
2021-08-22,S92000003,Scotland,3645,390638,7146.688620563484,432.1258690084156,4,8106,148.2985729967069,6764,2068153,37836.681302597884,27718,3817,13.770834836568296,10.65951865723991,7490,20228,54.0,,6.0,,123,3694,3645,390638,8106
2021-08-23,S92000003,Scotland,5518,396156,7247.639956092207,482.839370654958,7,8113,148.42663739480426,11898,2080051,38054.35418953531,51980,5763,11.08695652173913,11.187103077674646,19011,32969,76.0,,7.0,,248,5515,5518,396156,8113
2021-08-24,S92000003,Scotland,5597,401753,7350.036589828029,523.7285034760337,4,8117,148.49981705085986,10934,2090985,38254.39077936334,49734,5899,11.861101057626572,11.617180964951999,19376,30358,102.0,,5.0,,313,5586,5597,401753,8117
2021-08-25,S92000003,Scotland,6823,408576,7474.8627881448965,580.7903402854008,5,8122,148.59129162092938,11562,2102547,38465.916575192095,49771,7205,14.476301460689962,12.202110076379233,14707,35064,107.0,,7.0,,295,6910,6823,408576,8122
2021-08-26,S92000003,Scotland,7223,415799,7607.006952067325,645.042078302232,5,8127,148.6827661909989,12488,2115035,38694.38346139773,54748,7613,13.905530795645506,12.760278179004828,13103,41645,102.0,,9.0,,315,7298,7223,415799,8127
2021-08-27,S92000003,Scotland,6020,421819,7717.142334431028,692.5722649103549,10,8137,148.86571533113795,11673,2126708,38907.93999268203,47745,6397,13.398261598073097,13.086489356820225,10815,36930,106.0,,8.0,,262,6135,6020,421819,8137
2021-08-28,S92000003,Scotland,4736,426555,7803.787047200879,723.7833882180754,8,8145,149.01207464324918,8833,2135541,39069.53896816685,32833,5032,15.326043919227605,13.266185312006204,5744,27089,103.0,,4.0,,225,4807,4736,426555,8145
2021-08-29,S92000003,Scotland,4431,430986,7884.851811196488,738.163190633004,8,8153,149.1584339553604,8044,2143585,39216.703256494686,33053,4821,14.585665446404256,13.3588024910587,7961,25092,92.0,,7.0,,220,4601,4431,430986,8153
2021-08-30,S92000003,Scotland,6519,437505,8004.116355653127,756.4763995609219,6,8159,149.26820343944382,14317,2157902,39478.631540431765,63769,6954,10.904985180887266,13.243058256671883,20964,42805,113.0,,6.0,,324,6630,6519,437505,8159
2021-08-31,S92000003,Scotland,6957,444462,8131.394072447859,781.3574826198317,10,8169,149.4511525795829,16070,2173972,39772.6308086352,65813,7371,11.199914910428033,13.054018612034554,19686,46127,131.0,,8.0,,329,7042,6957,444462,8169
2021-09-01,S92000003,Scotland,7491,451953,8268.441273326016,793.5784851811197,8,8177,149.5975118916941,15344,2189316,40053.34796926455,61329,7923,12.918847527270946,12.833922458181412,15484,45845,155.0,,8.0,,368,7555,7491,451953,8177
2021-09-02,S92000003,Scotland,7526,459479,8406.128796194658,799.1218441273328,11,8188,149.79875594584706,14519,2203835,40318.971825832414,61354,8023,13.07657202464387,12.714268535321512,13808,47546,131.0,,8.0,,374,7649,7526,459479,8188
2021-09-03,S92000003,Scotland,6130,465609,8518.27661909989,801.1342846688623,11,8199,150.0,12562,2216397,40548.792535675086,50375,6588,13.077915632754342,12.67536076152022,10972,39403,153.0,,7.0,,298,6290,6130,465609,8199
2021-09-04,S92000003,Scotland,4986,470595,8609.495060373216,805.7080131723383,10,8209,150.18294914013902,9819,2226216,40728.430296377606,35495,5357,15.092266516410765,12.67201525911398,5959,29536,123.0,,7.0,,221,5136,4986,470595,8209
2021-09-05,S92000003,Scotland,4900,475495,8699.140139041347,814.288327844859,17,8226,150.4939626783754,9715,2235931,40906.16538602269,37407,5263,14.06955917341674,12.642793615627545,7849,29558,113.0,,16.0,,211,5052,4900,475495,8226
2021-09-06,S92000003,Scotland,7086,482581,8828.77789974387,824.6615440907428,10,8236,150.67691181851444,17820,2253751,41232.18075375047,70065,7546,10.769999286376937,12.589370361252678,20180,49885,157.0,,13.0,,435,7111,7086,482581,8236
2021-09-07,S92000003,Scotland,6657,489238,8950.567142334432,819.1730698865715,18,8254,151.00622027076471,16414,2270165,41532.47347237468,66706,7093,10.633226396426108,12.487360574398206,20300,46406,200.0,,12.0,,450,6643,6657,489238,8254
2021-09-08,S92000003,Scotland,6208,495446,9064.141968532747,795.7006952067325,10,8264,151.18916941090376,15143,2285308,41809.51335528723,59098,6650,11.252495854343634,12.226018396846257,15643,43455,167.0,,10.0,,397,6253,6208,495446,8264
2021-09-09,S92000003,Scotland,5516,500962,9165.056714233442,758.9279180387853,17,8281,151.50018294914014,13840,2299148,42062.71496523966,55559,5950,10.709336021166687,11.861864666871273,13281,42278,165.0,,9.0,,323,5627,5516,500962,8281
2021-09-10,S92000003,Scotland,4756,505718,9252.067325283571,733.790706183681,25,8306,151.95755579948775,11672,2310820,42276.25320160995,46012,5133,11.155785447274623,11.608729228658914,10828,35184,170.0,,10.0,,315,4818,4756,505718,8306
2021-09-11,S92000003,Scotland,3616,509334,9318.221734357849,708.7266739846323,21,8327,152.34174899377967,8904,2319724,42439.151115989764,30441,3902,12.81823855983706,11.371027791769786,5660,24781,132.0,,13.0,,254,3648,3616,509334,8327
2021-09-12,S92000003,Scotland,3353,512687,9379.564581046468,680.4244420051226,22,8349,152.74423710208558,8866,2328590,42601.35382363703,32143,3603,11.209283514295487,11.076206030709065,7860,24283,137.0,,12.0,,215,3388,3353,512687,8349
2021-09-13,S92000003,Scotland,5053,517740,9472.008781558729,643.2308818148555,21,8370,153.12843029637762,15549,2344139,42885.82144163924,62676,5490,8.759333716255027,10.725254157982047,20488,42188,175.0,,9.0,,373,5117,5053,517740,8370
2021-09-14,S92000003,Scotland,4745,522485,9558.8181485547,608.2510062202707,20,8390,153.4943285766557,13939,2358078,43140.83424807904,58239,5110,8.774189117258196,10.412937867553056,19819,38420,158.0,,7.0,,368,4742,4745,522485,8390
2021-09-15,S92000003,Scotland,4050,526535,9632.912550311014,568.7705817782656,23,8413,153.91511159897547,11607,2369685,43353.18331503842,47339,4370,9.23128921185492,10.095394529028995,14316,33023,170.0,,11.0,,303,4067,4050,526535,8413
2021-09-16,S92000003,Scotland,3555,530090,9697.950969630445,532.8942553969996,16,8429,154.207830223198,10425,2380110,43543.90779363337,43742,3888,8.888482465365096,9.824324998752306,12419,31323,156.0,,9.0,,294,3594,3555,530090,8429
2021-09-17,S92000003,Scotland,3354,533444,9759.312111233075,507.244785949506,24,8453,154.64690815953162,9239,2389349,43712.93450420784,37797,3676,9.725639601026538,9.616264961889,10433,27364,140.0,,15.0,,270,3406,3354,533444,8453
2021-09-18,S92000003,Scotland,2604,536048,9806.952067325285,488.730332967435,21,8474,155.03110135382366,7097,2396446,43842.773508964514,25098,2838,11.307673918240495,9.437065601855169,5444,19654,114.0,,13.0,,198,2640,2604,536048,8474
2021-09-19,S92000003,Scotland,2781,538829,9857.83022319795,478.26564215148176,28,8502,155.54335894621295,7194,2403640,43974.38712038054,27792,3011,10.83405296488198,9.377137136872571,7503,20289,102.0,,6.0,,201,2810,2781,538829,8502
2021-09-20,S92000003,Scotland,3991,542820,9930.845225027442,458.8364434687157,20,8522,155.90925722649104,12500,2416140,44203.07354555433,53274,4284,8.041446108796036,9.266539598542014,18878,34396,150.0,,7.0,,383,3901,3991,542820,8522
2021-09-21,S92000003,Scotland,3780,546600,10000.0,441.1818514452983,21,8543,156.29345042078302,11356,2427496,44410.83058909623,50952,4056,7.960433349034385,9.134107708553326,19374,31578,117.0,,8.0,,345,3711,3780,546600,8543
2021-09-22,S92000003,Scotland,3488,550088,10063.812660080495,430.9001097694841,31,8574,156.8605927552141,9917,2437413,44592.26125137212,43389,3771,8.691142916407385,9.049651827374454,14973,28416,107.0,,10.0,,340,3431,3488,550088,8574
2021-09-23,S92000003,Scotland,3096,553184,10120.453713867544,422.5027442371022,19,8593,157.2081961214783,8838,2446251,44753.951701427,40340,3374,8.363906792265741,8.975674880312374,12033,28307,130.0,,4.0,,249,3125,3096,553184,8593
2021-09-24,S92000003,Scotland,2698,555882,10169.813391877058,410.5012806439809,22,8615,157.61068422978408,7643,2453894,44893.779729235284,32331,2913,9.009928551544958,8.875962749289835,9388,22943,108.0,,9.0,,241,2672,2698,555882,8615
2021-09-25,S92000003,Scotland,2125,558007,10208.690084156604,401.73801683132086,21,8636,157.9948774240761,5956,2459850,45002.74423710209,21895,2271,10.37223110299155,8.771247495119884,5218,16677,86.0,,7.0,,143,2128,2125,558007,8636
2021-09-26,S92000003,Scotland,2135,560142,10247.74972557629,389.91950237833885,20,8656,158.36077570435418,5595,2465445,45105.10428100988,23572,2284,9.689462073646697,8.636967409587097,7346,16226,82.0,,2.0,,178,2106,2135,560142,8656
2021-09-27,S92000003,Scotland,3112,563254,10304.68349798756,373.83827296011714,24,8680,158.7998536406879,9495,2474940,45278.8144895719,44786,3339,7.4554548296342595,8.554603230132352,18051,26735,117.0,,9.0,,307,3032,3112,563254,8680
2021-09-28,S92000003,Scotland,3175,566429,10362.769849981703,362.7698499817051,16,8696,159.09257226491042,9775,2484715,45457.64727405781,46492,3422,7.3604060913705585,8.454737841419275,19163,27329,118.0,,5.0,,327,3095,3175,566429,8696
2021-09-29,S92000003,Scotland,2586,569015,10410.08049762166,346.26783754116354,25,8721,159.54994511525794,8118,2492833,45606.16538602269,38312,2832,7.391939862184173,8.248966608538396,14840,23472,102.0,,5.0,,252,2580,2586,569015,8721
2021-09-30,S92000003,Scotland,2360,571375,10453.256494694477,332.80278082693013,16,8737,159.84266373948043,7282,2500115,45739.388949871936,35787,2551,7.128286808058793,8.064973784311709,12425,23362,88.0,,6.0,,241,2310,2360,571375,8737
2021-10-01,S92000003,Scotland,2040,573415,10490.57811928284,320.76472740578123,19,8756,160.1902671057446,6523,2506638,45858.72667398463,29626,2210,7.45966380881658,7.863350937746913,9656,19970,101.0,,6.0,,187,2023,2040,573415,8756
2021-10-02,S92000003,Scotland,1860,575275,10524.6066593487,315.91657519209656,23,8779,160.6110501280644,5163,2511801,45953.18331503842,20170,1983,9.831432821021318,7.799535068797254,5568,14602,88.0,,8.0,,157,1826,1860,575275,8779
2021-10-03,S92000003,Scotland,1979,577254,10560.812294182215,313.06256860592754,15,8794,160.885473838273,4975,2516776,46044.2005122576,22451,2094,9.326978753730346,7.756371410295258,7495,14956,86.0,,7.0,,150,1944,1979,577254,8794
2021-10-04,S92000003,Scotland,2945,580199,10614.690815953165,310.00731796560564,14,8808,161.14160263446763,9953,2526729,46226.28979143798,46074,3144,6.823805182966533,7.6329359764264675,18997,27077,132.0,,7.0,,262,2882,2945,580199,8808
2021-10-05,S92000003,Scotland,2831,583030,10666.483717526527,303.71386754482256,23,8831,161.56238565678743,8497,2535226,46381.74167581413,41945,3017,7.192752413875313,7.608217950632563,18355,23590,107.0,,6.0,,276,2741,2831,583030,8831
2021-10-06,S92000003,Scotland,2637,585667,10714.727405781192,304.6469081595316,13,8844,161.80021953896818,7320,2542546,46515.6604463959,35654,2857,8.013126156952938,7.706284229652102,14266,21388,86.0,,7.0,,259,2598,2637,585667,8844
2021-10-07,S92000003,Scotland,2594,588261,10762.18441273326,308.92791803878515,19,8863,162.14782290523237,6935,2549481,46642.535675082334,34483,2779,8.059043586694893,7.8488561346857475,12202,22281,118.0,,4.0,,251,2528,2594,588261,8863
2021-10-08,S92000003,Scotland,2279,590540,10803.878521770948,313.30040248810826,14,8877,162.403951701427,6303,2555784,46757.848518111976,28911,2462,8.515789837778009,7.9830030301974855,9668,19243,108.0,,9.0,,222,2240,2279,590540,8877
2021-10-09,S92000003,Scotland,2129,592669,10842.82839370655,318.2217343578485,17,8894,162.71496523966337,4793,2560577,46845.536040980616,19132,2258,11.802216182312355,8.139514541876231,5218,13914,93.0,,9.0,,177,2081,2129,592669,8894
2021-10-10,S92000003,Scotland,1879,594548,10877.204537138676,316.3922429564581,14,8908,162.97109403585804,4632,2565209,46930.27808269301,20432,1992,9.749412685982774,8.167020398798046,7099,13333,73.0,,5.0,,158,1834,1879,594548,8908
2021-10-11,S92000003,Scotland,2813,597361,10928.668130259788,313.9773143066228,22,8930,163.37358214416392,8095,2573304,47078.37541163556,40202,3004,7.47226506143973,8.320838561508253,18014,22188,89.0,,3.0,,254,2750,2813,597361,8930
2021-10-12,S92000003,Scotland,2620,599981,10976.600804976215,310.117087449689,16,8946,163.6663007683864,7428,2580732,47214.27003293084,37691,2782,7.381072404552809,8.37578808803492,17677,20014,99.0,,3.0,,241,2541,2620,599981,8946
2021-10-13,S92000003,Scotland,2630,602611,11024.716428832784,309.98902305159163,19,8965,164.01390413465055,6381,2587113,47331.009879253565,32318,2779,8.598923200693113,8.470274758524926,13803,18515,83.0,,3.0,,203,2576,2630,602611,8965
2021-10-14,S92000003,Scotland,2673,605284,11073.61873399195,311.4343212586901,20,8985,164.37980241492863,5658,2592771,47434.522502744236,30927,2870,9.279917224431728,8.657382891328306,11608,19319,116.0,,9.0,,269,2601,2673,605284,8985
2021-10-15,S92000003,Scotland,2568,607852,11120.600073179658,316.72155140870836,16,9001,164.67252103915112,5592,2598363,47536.82766190999,27327,2705,9.89863504958466,8.840113638002393,9649,17678,120.0,,8.0,,219,2486,2568,607852,9001
2021-10-16,S92000003,Scotland,2149,610001,11159.915843395536,317.08744968898645,18,9019,165.0018294914014,4824,2603187,47625.082327113065,19410,2258,11.633178773827925,8.82831589912965,5136,14274,81.0,,3.0,,148,2110,2149,610001,9019
2021-10-17,S92000003,Scotland,2299,612300,11201.975850713501,324.7713135748262,15,9034,165.27625320160996,4910,2608097,47714.910354921325,22168,2435,10.984301696138578,8.966259289764476,7027,15141,67.0,,4.0,,150,2285,2299,612300,9034
2021-10-18,S92000003,Scotland,2950,615250,11255.94584705452,327.2777167947312,15,9049,165.5506769118185,9021,2617118,47879.94877424076,43461,3127,7.194956397689882,8.886930267883098,18227,25234,118.0,,7.0,,257,2870,2950,615250,9049
2021-10-19,S92000003,Scotland,2764,618014,11306.51298938895,329.91218441273327,9,9058,165.71533113794362,8730,2625848,48039.663373582145,42041,2948,7.012202373873124,8.785584327274734,17747,24294,127.0,,10.0,,273,2675,2764,618014,9058
2021-10-20,S92000003,Scotland,2840,620854,11358.470545188435,333.7541163556532,16,9074,166.0080497621661,8276,2634124,48191.07208196122,37432,3066,8.190852746313317,8.71272994981281,13960,23472,119.0,,9.0,,309,2757,2840,620854,9074
2021-10-21,S92000003,Scotland,2536,623390,11404.8664471277,331.24771313574826,22,9096,166.41053787047198,7742,2641866,48332.71130625687,35931,2720,7.570064846511369,8.455459454713088,11524,24407,98.0,,8.0,,231,2489,2536,623390,9096
2021-10-22,S92000003,Scotland,2444,625834,11449.579216977681,328.97914379802415,16,9112,166.70325649469447,7769,2649635,48474.84449323089,32425,2614,8.061680801850423,8.231272652318049,9932,22493,107.0,,11.0,,184,2430,2444,625834,9112
2021-10-23,S92000003,Scotland,2132,627966,11488.583973655324,328.6681302597878,23,9135,167.12403951701427,6254,2655889,48589.260885473836,22734,2295,10.09501187648456,8.131096734859772,5275,17459,79.0,,5.0,,185,2110,2132,627966,9135
2021-10-24,S92000003,Scotland,2319,630285,11531.009879253566,329.0340285400658,21,9156,167.50823271130625,6657,2662546,48711.0501280644,26397,2478,9.387430389817023,8.005956218466773,7441,18956,73.0,,3.0,,176,2302,2319,630285,9156
2021-10-25,S92000003,Scotland,3296,633581,11591.309915843396,335.3640687888767,8,9164,167.65459202341748,10840,2673386,48909.36699597512,48643,3553,7.304236991961845,8.010488471232026,18377,30266,121.0,,9.0,,333,3220,3296,633581,9164
2021-10-26,S92000003,Scotland,2916,636497,11644.65788510794,338.14489571899014,19,9183,168.00219538968167,10111,2683497,49094.346871569694,46007,3148,6.84243702045341,7.963328778814676,18956,27051,112.0,,8.0,,305,2843,2916,636497,9183
2021-10-27,S92000003,Scotland,2651,639148,11693.157702158798,334.68715697036225,14,9197,168.25832418587638,8233,2691730,49244.96889864617,37394,2888,7.723164143980317,7.893207657565592,14666,22728,110.0,,9.0,,292,2596,2651,639148,9197
2021-10-28,S92000003,Scotland,2497,641645,11738.84010245152,333.97365532382,20,9217,168.6242224661544,7101,2698831,49374.881083058914,34222,2705,7.904272105663023,7.9415871068750965,11872,22350,109.0,,11.0,,246,2459,2497,641645,9217
2021-10-29,S92000003,Scotland,2547,644192,11785.437248444932,335.85803146725215,19,9236,168.97182583241855,7613,2706444,49514.160263446756,31747,2726,8.58663810753772,8.008691289288835,10343,21404,104.0,,9.0,,290,2436,2547,644192,9236
2021-10-30,S92000003,Scotland,2029,646221,11822.557628979142,333.97365532382,16,9252,169.26454445664106,6340,2712784,49630.15001829493,21957,2177,9.914833538279362,7.9860533269471965,5215,16742,77.0,,6.0,,147,2030,2029,646221,9252
2021-10-31,S92000003,Scotland,2071,648292,11860.446395901941,329.4365166483717,16,9268,169.55726308086352,6697,2719481,49752.67105744604,23579,2215,9.393952245642307,7.970470008088722,6441,17138,81.0,,4.0,,160,2055,2071,648292,9268
2021-11-01,S92000003,Scotland,3301,651593,11920.837907061836,329.52799121844123,27,9295,170.05122575923897,10908,2730389,49952.2319795097,47917,3480,7.262558173508358,7.964237325129827,18333,29584,128.0,,9.0,,320,3160,3301,651593,9295
2021-11-02,S92000003,Scotland,3046,654639,11976.564215148188,331.9063300402488,13,9308,170.2890596414197,9611,2740000,50128.064398097325,45859,3243,7.071676224950393,8.008241475224063,19848,26011,104.0,,6.0,,276,2967,3046,654639,9308
2021-11-03,S92000003,Scotland,2983,657622,12031.137943651665,337.980241492865,16,9324,170.58177826564216,8056,2748056,50275.44822539334,38401,3137,8.16905809744538,8.07733029111711,15046,23355,88.0,,4.0,,254,2883,2983,657622,9324
2021-11-04,S92000003,Scotland,2798,660420,12082.327113062569,343.4870106110501,22,9346,170.98426637394806,6953,2755009,50402.65276253201,35554,2955,8.311301119423975,8.135453484290693,12218,23336,86.0,,6.0,,222,2733,2798,660420,9346
2021-11-05,S92000003,Scotland,2781,663201,12133.205268935237,347.76802049030374,17,9363,171.2952799121844,6976,2761985,50530.27808269302,31976,2942,9.2006504878659,8.215932768723267,10779,21197,89.0,,8.0,,241,2701,2781,663201,9363
2021-11-06,S92000003,Scotland,2226,665427,12173.929747530186,351.3721185510428,17,9380,171.60629345042082,5156,2767141,50624.60665934871,20714,2335,11.272569276817613,8.322540983606558,5342,15372,61.0,,5.0,,125,2210,2226,665427,9380
2021-11-07,S92000003,Scotland,2301,667728,12216.02634467618,355.5799487742408,12,9392,171.8258324185876,4625,2771766,50709.220636663005,21537,2428,11.273622138645125,8.48081071921573,6529,15008,79.0,,6.0,,163,2265,2301,667728,9392
2021-11-08,S92000003,Scotland,3821,671549,12285.931211123308,365.09330406147086,12,9404,172.04537138675445,9079,2780845,50875.32016099524,47063,4014,8.528993051866648,8.732331276129802,18423,28640,102.0,,12.0,,271,3743,3821,671549,9404
2021-11-09,S92000003,Scotland,3454,675003,12349.121844127332,372.55762897914383,6,9410,172.1551408708379,8818,2789663,51036.644712769856,45044,3648,8.09874789095107,8.930496194166192,19273,25771,98.0,,5.0,,306,3342,3454,675003,9410
2021-11-10,S92000003,Scotland,3292,678295,12409.348701061106,378.21075740944013,14,9424,172.41126966703254,7323,2796986,51170.61836809368,37900,3464,9.139841688654354,9.085525547567016,14931,22969,78.0,,6.0,,236,3228,3292,678295,9424
2021-11-11,S92000003,Scotland,3213,681508,12468.13025978778,385.80314672521035,8,9432,172.55762897914383,7058,2804044,51299.743871203806,36707,3415,9.303402620753532,9.232965746801085,12369,24338,94.0,,7.0,,248,3167,3213,681508,9432
2021-11-12,S92000003,Scotland,2857,684365,12520.398829125503,387.1935601902671,17,9449,172.86864251738015,6703,2810747,51422.374679839006,33000,3043,9.221212121212124,9.235633252743165,11152,21848,78.0,,7.0,,225,2818,2857,684365,9449
2021-11-13,S92000003,Scotland,2319,686684,12562.824734723748,388.89498719356015,10,9459,173.0515916575192,4612,2815359,51506.75082327113,20726,2478,11.955997298079708,9.294271769630996,5375,15351,51.0,,4.0,,106,2372,2319,686684,9459
2021-11-14,S92000003,Scotland,2424,689108,12607.171606293447,391.14526161727036,15,9474,173.32601536772773,4301,2819660,51585.437248444934,21534,2576,11.962477941859383,9.355550596345061,6155,15379,71.0,,6.0,,155,2421,2424,689108,9474
2021-11-15,S92000003,Scotland,3642,692750,12673.801683132087,387.8704720087817,19,9493,173.6736187339919,7697,2827357,51726.25320160995,44379,3838,8.648234525338559,9.386936353378744,18098,26281,84.0,,13.0,,232,3606,3642,692750,9493
2021-11-16,S92000003,Scotland,3280,696030,12733.809001097696,384.6871569703623,5,9498,173.76509330406148,7567,2834924,51864.69081595317,43939,3477,7.913243360112884,9.358691773201503,19773,24166,99.0,,3.0,,251,3226,3280,696030,9498
2021-11-17,S92000003,Scotland,3315,699345,12794.456641053786,385.107939992682,12,9510,173.9846322722283,6507,2841431,51983.73582144164,36757,3500,9.521995810321844,9.419005914563664,14444,22313,73.0,,6.0,,247,3253,3315,699345,9510
2021-11-18,S92000003,Scotland,2992,702337,12849.195023783388,381.0647639956092,9,9519,174.14928649835346,6089,2847520,52095.133552872314,34825,3138,9.010768126346015,9.376594658955604,11899,22926,76.0,,11.0,,209,2929,2992,702337,9519
2021-11-19,S92000003,Scotland,2785,705122,12900.146359312112,379.7475301866081,9,9528,174.3139407244786,5362,2852882,52193.230881814874,30105,2987,9.921939877096829,9.469356123393537,10610,19495,63.0,,1.0,,173,2814,2785,705122,9528
2021-11-20,S92000003,Scotland,2215,707337,12940.669593852908,377.8448591291622,10,9538,174.49688986461763,4011,2856893,52266.61178192462,19352,2354,12.164117403885903,9.472001940309497,5059,14293,49.0,,6.0,,91,2263,2215,707337,9538
2021-11-21,S92000003,Scotland,2174,709511,12980.442736919138,373.27113062568606,9,9547,174.6615440907428,3857,2860750,52337.17526527624,20302,2299,11.3240074869471,9.402200654013123,6371,13931,49.0,,6.0,,95,2204,2174,709511,9547
2021-11-22,S92000003,Scotland,3160,712671,13038.25466520307,364.45298207098426,15,9562,174.93596780095137,7155,2867905,52468.075375045744,42718,3338,7.814036237651575,9.25139694207844,18178,24540,83.0,,8.0,,202,3136,3160,712671,9562
2021-11-23,S92000003,Scotland,2880,715551,13090.944017563115,357.1350164654226,12,9574,175.1555067691182,7000,2874905,52596.13977314307,41644,3067,7.364806454711362,9.163812621010797,19492,22152,61.0,,8.0,,207,2860,2880,715551,9574
2021-11-24,S92000003,Scotland,2896,718447,13143.926088547383,349.4694474935968,5,9579,175.2469813391877,5735,2880640,52701.061105012814,34426,3103,9.013536280718062,9.081711226116077,14250,20176,88.0,,5.0,,218,2885,2896,718447,9579
2021-11-25,S92000003,Scotland,2491,720938,13189.498719356021,340.30369557263083,10,9589,175.42993047932674,5365,2886005,52799.2133186974,32091,2652,8.263999252126766,8.973975471133713,11707,20384,64.0,,4.0,,168,2484,2491,720938,9589
2021-11-26,S92000003,Scotland,2237,723175,13230.424442005124,330.27808269301136,15,9604,175.70435418953528,4566,2890571,52882.74789608488,27311,2379,8.710775877851415,8.809974109913517,10708,16603,57.0,,4.0,,174,2205,2237,723175,9604
2021-11-27,S92000003,Scotland,1882,725057,13264.855470179293,324.1858763263813,13,9617,175.9421880717161,3460,2894031,52946.048298573,17527,2023,11.54219204655674,8.731176424296011,5231,12296,56.0,,7.0,,136,1887,1882,725057,9617
2021-11-28,S92000003,Scotland,2332,727389,13307.519209659717,327.07647274057814,16,9633,176.2349066959386,3724,2897755,53014.17855836078,20131,2453,12.185187024986341,8.809439976279604,5988,14143,50.0,,6.0,,140,2313,2332,727389,9633
2021-11-29,S92000003,Scotland,3457,730846,13370.764727405782,332.5100622027077,11,9644,176.43615075009149,6898,2904653,53140.37687522869,44002,3653,8.301895368392348,8.902418805150782,18073,25929,76.0,,3.0,,247,3406,3457,730846,9644
2021-11-30,S92000003,Scotland,3295,734141,13431.046469081597,340.10245151847784,3,9647,176.49103549213314,7258,2911911,53273.16136114161,44104,3491,7.915381824777797,8.995773980837189,19525,24579,60.0,,9.0,,239,3252,3295,734141,9647
2021-12-01,S92000003,Scotland,3092,737233,13487.614343212583,343.6882546652031,14,9661,176.74716428832784,6937,2918848,53400.07317965607,39355,3294,8.369965696861899,8.88335612258987,14455,24900,56.0,,2.0,,187,3107,3092,737233,9661
2021-12-02,S92000003,Scotland,2923,740156,13541.090376875227,351.59165751920966,11,9672,176.94840834248075,6672,2925520,53522.136845956826,37646,3131,8.316952664293684,8.87706670839201,11983,25663,50.0,,5.0,,173,2958,2923,740156,9672
2021-12-03,S92000003,Scotland,2639,742795,13589.370654957922,358.9462129527992,6,9678,177.05817782656422,6203,2931723,53635.62019758508,33118,2835,8.560299534996076,8.85184604231759,10445,22673,43.0,,3.0,,148,2687,2639,742795,9678
2021-12-04,S92000003,Scotland,2123,744918,13628.21075740944,363.35528723015,12,9690,177.2777167947311,4668,2936391,53721.020856201976,21879,2293,10.480369303898717,8.803879534622347,5249,16630,54.0,,4.0,,122,2171,2123,744918,9690
2021-12-05,S92000003,Scotland,2482,747400,13673.618733991949,366.0995243322357,8,9698,177.4240761068423,4873,2941264,53810.171972191725,24356,2657,10.909016258827393,8.735171398183754,5981,18375,49.0,,2.0,,128,2529,2482,747400,9698
2021-12-06,S92000003,Scotland,3767,751167,13742.535675082328,371.7709476765458,12,9710,177.64361507500908,8468,2949732,53965.093304061484,49833,4013,8.052896674894146,8.675501716002573,18107,31726,83.0,,3.0,,268,3745,3767,751167,9710
2021-12-07,S92000003,Scotland,3722,754889,13810.629345042078,379.58287596048297,18,9728,177.9729235272594,8170,2957902,54114.562751555066,48984,3983,8.131226522946267,8.702399567348955,19769,29215,76.0,,4.0,,242,3741,3722,754889,9728
2021-12-08,S92000003,Scotland,4123,759012,13886.059275521406,398.4449323088181,10,9738,178.15587266739846,8334,2966236,54267.03256494695,47076,4420,9.38907298835925,8.875127428754011,15350,31726,69.0,,5.0,,241,4179,4123,759012,9738
2021-12-09,S92000003,Scotland,3964,762976,13958.580314672525,417.4899377972924,8,9746,178.30223197950968,7911,2974147,54411.763629710935,45023,4295,9.539568664904603,9.063562598744213,12590,32433,75.0,,2.0,,205,4090,3964,762976,9746
2021-12-10,S92000003,Scotland,3719,766695,14026.619099890231,437.24844493230887,7,9753,178.43029637760705,7403,2981550,54547.200878155876,40494,3961,9.781696053736356,9.228331142286013,11048,29446,46.0,,3.0,,195,3766,3719,766695,9753
2021-12-11,S92000003,Scotland,3230,769925,14085.711672155141,457.5009147457007,8,9761,178.57665568971825,5907,2987457,54655.268935235996,29159,3476,11.920847765698412,9.407738878652276,5633,23526,35.0,,2.0,,159,3317,3230,769925,9761
2021-12-12,S92000003,Scotland,3326,773251,14146.560556165388,472.94182217343575,7,9768,178.7047200878156,5839,2993296,54762.09293816319,30632,3566,11.641420736484726,9.517137647192149,6632,24000,36.0,,5.0,,139,3427,3326,773251,9768
2021-12-13,S92000003,Scotland,5595,778846,14248.920600073176,506.3849249908527,3,9771,178.75960482985732,10717,3004013,54958.1595316502,63361,6061,9.565821246508104,9.76671074955124,19098,44263,72.0,,4.0,,310,5751,5595,778846,9771
2021-12-14,S92000003,Scotland,6239,785085,14363.062568605928,552.4332235638492,6,9777,178.86937431394074,10603,3014616,55152.14050493963,63669,6826,10.721073049678806,10.207755452171787,20392,43277,49.0,,3.0,,322,6504,6239,785085,9777
2021-12-15,S92000003,Scotland,6786,791871,14487.211855104282,601.152579582876,3,9780,178.9242590559824,10352,3024968,55341.52945481156,59476,7474,12.566413343197254,10.746683382859073,16053,43423,,:,6.0,,306,7168,6786,791871,9780
2021-12-16,S92000003,Scotland,6101,797972,14598.82912550311,640.248810830589,1,9781,178.94255396999634,8779,3033747,55502.14050493962,52753,6790,12.871305897294938,11.236835284970427,13365,39388,,:,7.0,,289,6501,6101,797972,9781
2021-12-17,S92000003,Scotland,5076,803048,14691.694109037688,665.075009147457,0,9781,178.94255396999634,6961,3040708,55629.49140139042,40170,5600,13.940751804829473,11.730735216083955,10224,29946,,:,3.0,,249,5351,5076,803048,9781
2021-12-18,S92000003,Scotland,3610,806658,14757.73874862788,672.0270764727406,0,9781,178.94255396999634,4188,3044896,55706.11050128065,23326,4054,17.379747920775102,12.109350394586473,4523,18803,,:,1.0,,167,3887,3610,806658,9781
2021-12-19,S92000003,Scotland,37,806695,14758.415660446397,611.8551042810099,0,9781,178.94255396999634,223,3045119,55710.19026710574,1395,47,3.3691756272401427,12.116389939174747,1349,46,,:,0.0,,47,0,37,806695,9781
